Glossary translated in Hindi	
Copyright CDAC(Formerly NCST) 2003
----------------------------------
About	के बारे में
About InfoZIP	InfoZIP के बारे में
About OpenOffice	OpenOffice के बारे में
About Setup	सेटप के बारे में
Above	ऊपर
Above/Below	ऊपर/नीचे
ABS	ABS
Absolute Record	निश्चित अभिलेख
Absolute Value	निश्चित मूल्य
Abstract:	उपसंक्षेप:
Accept	स्वीकार
Accept All	सब स्वीकृत
Accept Changes	परिवर्तनों को स्वीकृत करो
Accept or Difscard	स्वीकार अथवा अस्वीकार
Accept with	स्वीकार्य सहित
Accepted	स्वीकृत
Access denied	प्रवेश निषेध
Accessed	प्रवेश की हुयी
Account	हिसाब
Account name	हिसाब नाम
ACOS	ACOS
ACOSH	ACOSH
ACOT	ACOT
ACOTH	ACOTH
Action	कार्य
Action discontinued	कार्य विरामित
Action not supported	कार्य असमर्थित
Activate	संचालित करो
Activate Document	लेखपत्र संचालित करो
Activate Test Mode	जाँच प्रकार संचालित करो
Active	क्रियाशील
Active Folders	क्रियाशील कोष्ठ
Active Link	क्रियाशील कड़ी
Active Window	क्रियाशील विन्डो
Adabas D	Adabas D
Adabas Database	Adabas लेखासंचय
Adabas Installation	Adabas प्रतिष्ठापन
Adapt	स्वीकार करो
Adapt matrix area	कोष्ठ वर्ग क्षेत्र स्वीकार करो
Adapt object size	वस्तु परिमाण स्वीकार करो
Adapt Objects	वस्तुयें स्वीकार करो
Adapt row height	पंक्ति ऊँचाई स्वीकार करो
Add	जोड़ो
ADD	ADD
Add All	सब जोड़ो
Add AutoFormat	स्वचालित रचना जोड़ो
Add Background	पृष्ठभाग जोड़ो
Add Bookmark	पृष्ठसंकेत जोड़ो
Add characters	अक्षरों को जोड़ो
Add Column	स्तंभ जोड़ो
Add Comment	अपवाद जोड़ो
Add Entry	प्रविष्टि जोड़ो
Add Field	क्षेत्र जोड़ो
Add Folder Bookmark	कोष्ठ पृष्ठसंकेत जोड़ो
Add Graphics	सुचित्रों को जोड़ो
Add legend	लेज़ेंड जोड़ो
Add Link	कड़ी जोड़ो
Add Print Range	छपाई फैलाव जोड़ो
Add Table	सारणी जोड़ो
Add tables	सारणियों को जोड़ो
Add Unknown Words	अज्ञात शब्दों को जोड़ो
Add Watch	निरीक्षण जोड़ो
Add/remove users	उपभोक्ताओं को जोड़ो/हटाओ
Add-In	जोड़ो-इन
Adding new newsgroups	नया समाचार वर्गों को जोड़ रहा है
Add-Ins	जोड़ो-इन्स
Addition +	जोड +
Additional fonts	अतिरिक्त फॉन्ट्स
Additional formats	अतिरिक्त रचना
Additional info	अतिरिक्त सूचना
Additional information	अतिरिक्त सूचना
Additional scale factor	अतिरिक्त स्केल् फॉक्टर्
Additional Styles	अतिरिक्त शैलियाँ
Additional\nInformation	अतिरिक्त\nसूचना
Additonal Information	अतिरिक्त सूचना
Address	पता
sddress	पता
ADDRESS	ADDRESS
Address Book	पता पुस्तक
Address Book on/off	पता पुस्तक शुरु/बंद
Address field	पता क्षेत्र
Addressee	लेनेवाला
Addressee data	लेनेवाले का ड़ाटा
Addresses	पता
Adjust column width	स्तंभ चौड़ाई व्यवस्था करो
Adjust columns proportionally	स्तंभ को अनुरूप से व्यवस्था करो
Adjust Scale	स्केल् व्यवस्था करो
Adjust to contour	परिवेश तक व्यवस्था करो
Administration	प्रशासन
Administrator	प्रशासक
Advance slides	स्लइड़ों को आगे बढाओ
Advanced Filter	उच्च फ़िल्टर
Afrikaans	आफ्रिकन
After	के पश्चात
after	के पश्चात
After completion	समाप्ति के पश्चात
After current sheet	वर्तमान शीट् के पश्चात
After deleting	मिटाने के पश्चात
After insert	जोड़ने के पश्चात
After inserting AutoText	स्वचालित टेक्स्ट् जोड़ने के पश्चात
After record change	अभिलेख परिवर्तन के पश्चात
After resetting	पुनः स्थापित करने के पश्चात
After update	अपडेट् के पश्चात
agenda	कार्यावली
Agenda title	कार्यावली शीर्षक
Agenda topic	कार्यावली विषय
Agents	कार्यकर्ता
Aging	ऐजिंग
Aging degree	ऐजिंग डिग्री
agn	कार्यक्रम
Airbrush	एयर ब्रश
Albania	अल्बेनिया
Albanian	अल्बेनियन
aleph	अलेफ
Algeria	अल्जीरिया
Alias name	उपनाम
Align %O	%O का पंक्तिकरण
Align Bottom	तल का पंक्तिकरण
Align bottom	तल का पंक्तिकरण
Align Center	मध्य का पंक्तिकरण
Align Center Horizontally	समतल प्रकार से मध्य भाग का पंक्तिकरण
Align Center Vertically	लंबरूप प्रकार से मध्य भाग का पंक्तिकरण
Align centered	केन्द्रित पंक्तिकरण
align data source	डॉटा मूल की पंक्तिकरण
Align dots down	नीचे की ओर बिन्दी की पंक्तिकरण
Align Left	बायाँ ओर पंक्तिकरण
Align left	बायाँ ओर पंक्तिकरण
Align middle	मध्य भाग पंक्तिकरण
Align Right	दाहिनी ओर पंक्तिकरण
Align right	दाहिनी ओर पंक्तिकरण
Align to bottom	तल केलिए पंक्तिकरण
Align to Grid	जाल केलिए पंक्तिकरण
Align to grid	जाल केलिए पंक्तिकरण
Align to top	ऊपर केलिए पंक्तिकरण
Align Top	ऊपर केलिए पंक्तिकरण
Align Vertical Center	लंबरूप मध्य की पंक्तिकरण
Alignment	पंक्तिकरण
All	सब
All Axes	सब अक्ष रेखाएँ
All Axis Grids	सब अक्षरेखा जाल
All caps	सब बडे अक्षर
All Certificates	सब प्रमाणपत्र
All Charts	सब चार्ट
All Documents	सब लेखपत्र
All Fields	सब क्षेत्र
All files	सब फाइलें
All Folders	सब कोष्ठ
All groups	सब समूह
All Indexes	सब अनुक्रमणी
All languages	सब भाषाएँ
All levels	सब सतहें
All Messages	सब संदेश
All properties	सब विशेषतायें
All slides	सब स्लइडस
All Styles	सब शैलियाँ
All Titles	सब शीर्षक
All to [%]	सब [%] केलिए
All values	सब मूल्य
Allow	स्वीकार
Allow additions	जोड़ना स्वीकृत
Allow blanks	खाली स्वीकृत
Allow Effects	प्रभाव स्वीकृत
Allow Interaction	परस्पर सम्बन्ध की कार्य स्वीकृत
Allow modifications	परिवर्तन स्वीकृत
Allow quick editing	शीघ्र संपादन स्वीकृत
Along a Curve	वक्र के साथ-साथ
alpha	आल्फ़ा
Alphabetic Presentation Forms	वर्णमाला प्रस्तुति की फ़ॉर्म
Alphabetical delimiter	वर्णमाला परिसीमित करनेवाला
Alphabetical Index	वर्णमाला अनुक्रमणिका
alphanumeric	आल्फा न्यूमेरिक
Already completed	पहिले से समाप्त
Alter structure	बनावट बदलना
Alterations	परिवर्तन
alternating	वैकल्पिक
Alternative (Text only)	विकल्प (केवल टेक्स्ट्)
Alternative display	विकल्प प्रदर्शन
Alternative entry	विकल्प प्रविष्टि
Alternative Text	विकल्प टेक्स्ट्
Always	हमेशा
Always execute	हमेशा चलाओ
Always Replace	हमेशा प्रतिस्थापन
Ambient light	व्यापक प्रकाश
Amount	राशि
Analyze SQL command	SQL निर्देश का विश्लेषण
Anchor	जोड़
Anchor to Character	अक्षर केलिए जोड़
Anchor To Frame	फ्रेम का जोड़
Anchor To Page	पृष्ठ का जोड़
Anchor To Paragraph	परिच्छेद का जोड़
Anchor<->Text	जोड़<->शब्द
Anchoring	जोड़ना
AND	AND
And	और
and %2 "%4"	और %2 "%4"
and then	उसके बाद
Andorra	ऐन्डोरा
Angle	कोण
Angled Connector Line	कोणीय जोड़ने की रेखा
Angled Line	कोणीय रेखा
Animation	हूलास
Animation Effects	हूलास प्रभाव
Animation group	हूलास वर्ग
Animation order	हूलास क्रम
Animation parameters	हूलास पैरामीटर
Animations	हूलास
Animations allowed	हूलास स्वीकृत
Annotation	टिप्पणी
Anonymous user	अज्ञात उपभोक्ता
ANSI Text	ANSI टेक्स्ट्
Antigua and Barbuda	ऐन्टिगुआ और बर्बुदा
Any record	किसी अभिलेख
Appear	दृष्टिगोचर होना
Append	जोड़ो
Append Libraries	लैब्ररियों को जोड़ो
Append sheet	शीट् जोड़ो
Append space	अंतर जोड़ो
Apple Macintosh	Apple Macintosh
Apple/SGI Audio	Apple/SGI आडियो
Applet	एप्लेट्
Applets	एप्लेट्स
Application	कार्यक्रम
Applied	लागू किया
Applied Paragraph Styles	लागू की हुयी परिच्छेद शैलियाँ
Applied Styles	लागू की हुयी शैलियाँ
Apply	लागू करो
Apply 3D favorite	3D प्रिय लागू करो
Apply attributes	ऐट्रिब्यूट्स लागू करो
Apply AutoFormat Options	स्वचालित रचना की विकल्प लागू करो
Apply border	किनारा लागू करो
Apply Cell Style	कोष्ठ शैली लागू करो
Apply Columns	स्तंभों को लागू करो
Apply field format	क्षेत्र रचना लागू करो
Apply Filter	फ़िल्टर लागू करो
Apply frame style	फ्रेम शैली लागू करो
Apply Names	नामों को लागू करो
Apply Page Style	पृष्ठ शैली लागू करो
Apply presentation layout	प्रस्तुति अभिन्यास लागू करो
Apply replacement table	प्रतिस्थापना सारणी लागू करो
Apply Style	शैली लागू करो
Apply Styles	शैलियाँ लागू करो
Apply table attributes	सारणी ऐट्रिब्यूट्स लागू करो
Apply to	को लागू करो
Apply user data	उपभोक्ता ड़ॉटा लागू करो
Approved	परीक्षित
Apr	अप्रैल
April	अप्रैल
Arabian (Qatar)	अरेबियन (खतार)
Arabic	अरेबिक
Arabic (Algerian)	अरेबिक (अल्जीरियन)
Arabic (Bahrain)	अरेबिक (बहरिन)
Arabic (Egypt)	अरेबिक (इजिप्ट)
Arabic (Iraq)	अरेबिक (इराख)
Arabic (Jordan)	अरेबिक (जोर्डन)
Arabic (Kuwait)	अरेबिक (कुवैत)
Arabic (Lebanon)	अरेबिक (लेबनॉन)
Arabic (Libya)	अरेबिक (लिब्या)
Arabic (Morocco)	अरेबिक (मोरोक्को)
Arabic (Oman)	अरेबिक (ओमन)
Arabic (Saudi Arabia)	अरेबिक (सौदि अरेबिया)
Arabic (Saudi Arabia)	अरेबिक (सौदि अरेबिया)
Arabic (Syria)	अरेबिक (सिरिया)
Arabic (Tunisia)	अरेबिक (टुनिशिया)
Arabic (UAE)	अरेबिक (UAE)
Arabic (Yemen)	अरेबिक (येमन)
Arabic Extended	विस्तृत अरेबिक
Arabic Presentation Forms-A	अरेबिक प्रस्तुति फ़ॉर्म-A
Arabic Presentation Forms-B	अरेबिक प्रस्तुति फ़ॉर्म-B
Arc	चाप
Arccosine	आर्ककोसैन्
Arccotangent	आर्ककोटान्जेन्ट्
Archive file	आर्कैव फाइल
Arcs	चाप
Arcsine	आर्कसैन
Arctangent	आर्कटान्जेन्ट्
Area	विस्तीर्ण
Area attributes	विस्तीर्ण ऐट्रिब्यूट्स्
Area Hyperbolic Cosine	विस्तीर्ण हाइपरबोलिक कोसैन
Area Hyperbolic Cotangent	विस्तीर्ण हाइपरबोलिक कोटान्जेन्ट
Area Hyperbolic Sine	विस्तीर्ण हाइपरबोलिक सैन
Area Hyperbolic Tangent	विस्तीर्ण हाइपरबोलिक टान्जेन्ट
Area type	विस्तीर्ण वर्ग
Areas	विस्तीर्ण
AREAS	AREAS
Argentina	अर्जेन्टिना
Arguments	आर्गुमेन्ट्स
Armenia	अर्मेनिया
Armenian	अर्मेनियन
Armenian	अर्मेनियन
Arrange	क्रम में रखो
Arrange Horizontally	समतल प्रकार से क्रम में रखो
Arrange Icons	अइकॉनों को क्रम में रखो
Arrange Object	वस्तु को क्रम में रखो
Arrange order	क्रम में रखो
Arrange Vertically	लंबरूप प्रकार से क्रम में रखो
Arrange Windows	विन्डों को क्रम में रखो
Arrange Windows Horizontal	विन्डों को समतल प्रकार से क्रम में रखो
Arrange Windows Vertical	विन्डों को लंबरूप प्रकार से क्रम में रखो
Arrangement	क्रम से स्थापन
Array	श्रेणी
array	श्रेणी
Array already dimensioned	श्रेणी को पहिले से ही परिमाण दिया
array_x	श्रेणी_x
array_y	श्रेणी_y
Arrow	तीर
Arrow concave	नतोदर तीर
Arrow Style	तीर शैली
Arrow styles	तीर शैलियाँ
Arrowheads	तीर की चोटी
Arrows	तीर
Article	अन्तर्नियम
Artificial Turf	काल्पनिक टर्फ़
As	जैसे
As Button	बटन जैसे
As character	अक्षर जैसे
As Character	अक्षर जैसे
As icon	अइकॉन जैसे
As Link	कड़ी जैसे
As mail content	मेइल विषय जैसे
As Metafile	मेटा फाइल जैसे
as number	संख्या जैसे
as object	वस्तु जैसे
As outbox settings	औटबॉक्स निर्धारण जैसे
As Page Style	पृष्ठ शैली जैसे
as percentage	प्रतिशत जैसे
As picture	चित्र जैसे
As Table View	सारणी दृश्य जैसे
As Text	टेक्स्ट् जैसे
As text	टेक्स्ट् जैसे
Ascending	आरोहण क्रम
ASCII Filter Options	ASCII फ़िल्टर विकल्प
ASIN	ASIN
ASINH	ASINH
Assami	अस्सामी
Assign	निर्दिष्ट करो
Assign background page	पृष्ठभाग पृष्ठ को निर्दिष्ट करो
Assign columns	स्तंभों को निर्दिष्ट करो
Assign Database	लेखासंचय निर्दिष्ट करो
Assign events	घटनों को निर्दिष्ट करो
Assign ID	ID निर्दिष्ट करो
Assign Macro	मॉक्रो निर्दिष्ट करो
Assign Names	नामों को निर्दिष्ट करो
Assign Styles	शैलियों को निर्दिष्ट करो
Assignment	निर्दिष्ट करना
at	में
at bottom	तल में
At Character	अक्षर में
At Least	कम से कम
At the beginning	प्रारंभ में
At the end	अंत में
at the left	बायाँ ओर में
at the right	दाहिनी ओर में
at top	ऊपर में
ATAN	ATAN
ATAN2	ATAN2
ATANH	ATANH
Attach	बाँधो
Attach data	डॉटा बाँधो
Attach file	फाइल बाँधो
Attach File	फाइल बाँधो
Attachment	बाँधा हुआ
Attachments	बाँधा हुआ
Attributes	ऐट्रिब्यूट्स
Attributes/Lines	ऐट्रिब्यूट्स/रेखाएँ
Audio file	आडियो फाइल
Aug	अगस्त
August	अगस्त
Australia	आस्ट्रेलिया
Austria	आस्ट्रिया
Austrian Schilling	आस्ट्रियन शिल्लिंग
Authentify as administrator	प्रशासक जैसे प्रमाणित करो
Author	लेखक
Author(s)	लेखक
Auto	स्वचालित
Auto line length	स्वचालित ढंग से रेखा विस्तार
Auto reload every	स्वचालित ढंग से पुनः सबको भरो
AutoAbstract to Presentation	स्वचालित ढंग से उपसंक्षेप से प्रस्तुति तक
AutoAlign	स्वचालित ढंग से पंक्तिकरण
AutoArrange	स्वचालित ढंग से क्रम में रखो
AutoBrowse	स्वचालित ढंग से देखो
AutoCalculate	स्वचालित ढंग से गणना
AutoCalculation On/Off	स्वचालित ढंग से गणना शुरु/बंद
AutoCapitalize entries	स्वचालित ढंग से प्रविष्टियों को बड़े अक्षर में बदलो
AutoContour	स्वचालित ढंग से परिवेश
AutoCorrect	स्वचालित ढंग से ठीक करो
AutoCorrect Configuration	स्वचालित ढंग से रूपरेखा को ठीक करो
AutoCorrect/AutoFormat	स्वचालित ढंग से ठीक करना/रचना
AutoFill	स्वचालित ढंग से भरना
AutoFilter	स्वचालित ढंग से छानना
AutoFilter not possible	स्वचालित ढंग से छानना करना असंभव है
AutoFit	स्वचालित ढंग से योग्य बनाना
AutoFit frame height	फ्रेम ऊँचाई को स्वचालित ढंग से योग्य बनाना
AutoFit frame width	फ्रेम चौड़ाई को स्वचालित ढंग से योग्य बनाना
AutoFit height	ऊँचाई को स्वचालित ढंग से योग्य बनाना
AutoFit width	चौड़ाई को स्वचालित ढंग से योग्य बनाना
AutoFormat	स्वचालित रचना
AutoFormat Chart	चार्ट की स्वचालित रचना
AutoFormat Configuration	रूपरेखा की स्वचालित रचना
AutoFormat Table	सारणी का स्वचालित रचना
AutoHeight	स्वचालित ऊँचाई
AutoHorizontal	स्वचालित समतल
AutoInclude	स्वचालित अन्तर्गत करना
AutoIncrement	स्वचालित वृद्धि करना
AutoInput	स्वचालित इनपुट् देना
AutoInput On/Off	स्वचालित इनपुट् शुरु/बंद
AutoLoad	स्वचालित ढंग से भरो
AutoMail	स्वचालित ढंग से मेल करो
Automatic	स्वचालित
Automatic (random)	स्वचालित (आकस्मिक)
Automatic *bold*	स्वचालित *मोटा*
Automatic _underline_	स्वचालित _रेखांकित_
Automatic control focus	स्वचालित नियंत्रण केन्द्रिभूत होना
Automatic hyphenation	स्वचालित हाइफ़नेशन्
Automatic Row Break	स्वचालित पंक्ति की अंत
Automatic Sort	स्वचालित सोर्ट
Automatic word completion	स्वचालित शब्द समाप्ती
Automatically	स्वचालित प्रकार से
Automatically saved version	स्वचालित प्रकार से संचित की हुयी आवर्तन
AutoNumbering	स्वचालित संख्या दो
AutoOutline	स्वचालित बाहरी रूपरेखा दो
AutoPilot	ओटोपैलट्
AutoPilot Agenda	ओटोपैलट् कार्यावली
AutoPilot Fax	ओटोपैलट् फ़ॉक्स्
AutoPilot Forms	ओटोपैलट् फ़ॉर्म
AutoPilot Group Element	ओटोपैलट् समूह ऐलिमेन्ट्
AutoPilot Internet Setup	ओटोपैलट् इन्टरनेट् सेटप
AutoPilot Letter	ओटोपैलट् पत्र
AutoPilot Memo	ओटोपैलट् स्मृतिपत्र
AutoPilot Menu	ओटोपैलट् मेनु
AutoPilot Presentation	ओटोपैलट् प्रस्तुति
AutoPilot Query	ओटोपैलट् जानकारी
AutoPilot Report	ओटोपैलट् रिपोर्ट
AutoPilot Table	ओटोपैलट् सारणी
AutoPilot Table Element	ओटोपैलट् सारणी ऐलिमेन्ट्
AutoPilot Web Page	ओटोपैलट् वेब पृष्ठ
AutoPilot: Agenda	ओटोपैलट्: कार्यावली
AutoPilot: Fax	ओटोपैलट्: फ़ॉक्स
AutoPilot: Functions	ओटोपैलट्: फ़ंक्शन्स
AutoPilot: Letter	ओटोपैलट्: पत्र
AutoPilot: Memo	ओटोपैलट्: स्मृतिपत्र
AutoPilot: Presentation	ओटोपैलट्: प्रस्तुति
AutoPilots	ओटोपैलट्स
AutoPilots on/off	ओटोपैलट्स शुरु/बंद
AutoRefresh	स्वचालित नवीकरण
AutoReload	स्वचालित पुनः लोड करो
AutoSave	स्वचालित संचित करो
AutoSave every	सबको स्वचालित संचित करो
AutoShape Adjustment	स्वचालित आकार को व्यवस्था करना
AutoSize Text	स्वचालित परिमाण टेक्स्ट्
AutoSpellcheck	स्वचालित अक्षर की जाँच
AutoSpellcheck on/off	स्वचालित अक्षर की जाँच शुरु/बंद
AutoStart	स्वचालित प्रारंभ
AutoSwitch	स्वचालित स्विच
AutoText	स्वचालित टेक्स्ट्
AutoText - Group	स्वचालित टेक्स्ट् - समूह
AutoText - Section	स्वचालित टेक्स्ट् - विभाग
AutoText directory	स्वचालित टेक्स्ट् डैरक्टरी
AutoTransition	स्वचालित परिवर्तन
AutoType recognition	स्वचालित वर्ग की पहचान
AutoUpdate	स्वचालित अपडेट्
AutoUpdate Display	स्वचालित अपडेट् प्रदर्शन
AutoUpdate Traces	स्वचालित अपडेट् जाँच
AutoValue	स्वचालित मूल्य
AutoVertical	स्वचालित लंबरूप
AutoWidth	स्वचालित चौड़ाई
Available Databases	प्राप्य लेखासंचय
Available disk space	प्राप्य डिस्क जगह
AVEDEV	AVEDEV
Average	माध्य
average value line	माध्य मूल्य रेखा
AVERAGEA	AVERAGEA
Axes	अक्षरेखाएँ
AxesTitle On/Off	अक्षरेखा शीर्षक शुरु/बंद
Axial	अक्षरेखा सम्बन्धी
Axial light red/white	अक्षरेखा सम्बन्धी प्रकाश लाल/सफेद
Axis	अक्षरेखा
Axis at	में अक्षरेखा
Axis labels on/off	अक्षरेखा लेबिल शुरु/बंद
Axis marks	अक्षरेखा चिह्न
Axis rotation	अक्षरेखा घुमाव
Axis titles	अक्षरेखा शीर्षक
Axis titles on/off	अक्षरेखा शीर्षक शुरु/बंद
Azerbaijani	अज़ेरबइजानी
Azerbaijani (Cyrillic)	अज़ेरबइजानी (सिरिलिक)
Azerbaijani (Latin)	अज़ेरबइजानी (लेटिन)
Azeri	अज़ेरी
Back	पीछे
Back One	एक पीछे
Back side	पिछली ओर
Back to message	वापस सन्देश केलिए
Background	पृष्ठभाग
Background Color	पृष्ठभाग रंग
Background color	पृष्ठभाग रंग
Background fill	पृष्ठभाग भरना
Background objects	पृष्ठभाग वस्तु
Background Pattern	पृष्ठभाग नमूना
Background transparency	पृष्ठभाग पारदर्शकता
Background view	पृष्ठभाग दृश्य
Backgrounds	पृष्ठभाग
Backspace	बॉकस्पेस
Backup Copies	बैकप प्रतिलिपियाँ
Backup copy	बैकप प्रतिलिपि
Backup file	बैकप फाइल
Backup file information	बैकप फाइल सूचना
Backward	पिछली ओर
Backwards	पिछली ओर
Bahamas	बहमास
Balance columns	स्तंभों की समतोलन
Bar Width	पट्टी की चौड़ाई
Barbados	बार्बडोस
Bars	पट्टी
BASE	BASE
Base at Bottom	तल में आधार
Base at Top	ऊपर में आधार
Base format	आधार रचना
Base in Middle	मध्य में आधार
Base line	आधार रेखा
Base line centered	आधार रेखा केन्द्रित
Base size	आधार परिमाण
Based on	में आधारित
BASIC	BASIC
Basic Arabic	मूलभूत अरेबिक
BASIC Dialog	BASIC डयलॉग
Basic Georgian	मूलभूत जोर्जियन
Basic Greek	मूलभूत ग्रीक
Basic Hebrew	मूलभूत हिब्रू
Basic IDE	मूलभूत IDE
BASIC Initialization	BASIC इनिशियलैज़ेशन्
Basic Latin	मूलभूत लेटिन
BASIC Macros	BASIC मॉक्रोस
BASIC Module	BASIC मोड्यूल
BASIC runtime error	BASIC चलने के समय गलती
BASIC syntax error	BASIC सिन्टाक्स गलती
Basque	बास्क्
Batch file	समुदाय फाइल
BCC	BCC
Before	से पहिले
Before commencing	आरंभ करने से पहिले
Before current sheet	वर्तमान शीट् से पहिले
Before deletion	मिटाने से पहिले
Before insert	जोड़ने से पहिले
Before inserting AutoText	स्वचालित टेक्स्ट् को जोड़ने से पहिले
Before record change	अभिलेख परिवर्तन से पहिले
Before submitting	अनुरोध करने से पहिले
Before update	अपडेट् करने से पहिले
Begin horizontal	समतल प्रारंभ
Begin vertical	लंबरूप प्रारंभ
Behavior	चाल-ढ़ाल
Behind Object	वस्तु के पीछे
Belarus	बेलारस
Belgian Franc	बेल्जियन फ्रॉन्क
Belgium	बेल्जियम
Below	नीचे
below	नीचे
Below reference edge	रेफरेन्स किनारे के नीचे
below the line	रेखा के नीचे
Bengali	बेंगाली
Bermuda	बर्मुडा
Best viewed with	अच्छे से दिखना
beta	बीटा
BETADIST	BETADIST
BETAINV	BETAINV
between	बीच में
Bibliography	ग्रन्थ-सूची
Bibliography Database	ग्रन्थ-सूची लेखासंचय
Bibliography Entry	ग्रन्थ-सूची प्रविष्टि
Bibliography entry	ग्रन्थ-सूची प्रविष्टि
Bibliography Heading	ग्रन्थ-सूची शीर्षक
Binary	बैनरी
Binary file	बैनरी फाइल
Binary operator expected	बैनरी प्रवर्तक की प्रतीक्षा
BINOMDIST	BINOMDIST
Bitmap	बिटमॉप्
Bitmap object	बिटमॉप् वस्तु
Bitmap patterns	बिटमॉप् नमूनें
Bitmap Patterns	बिटमॉप् नमूनें
Bitmap scaling	बिटमॉप् स्केलिंग
Bitmaps	बिटमॉप्स
Black	काला
Black 45 degrees	काला 45 कोण
Black and white	काला और सफेद
Black and White	काला और सफेद
Black Italic	काला ढेड़ा
Black White	काला सफेद
Black/White	काला/सफेद
Blank	खाली
Blank graphic object	खाली सुचित्रित वस्तु
Blank graphic objects	खाली सुचित्रित वस्तु
blank group object	खाली समूह वस्तु
Blank group objects	खाली समूह वस्तु
Blank lines	खाली रेखाएँ
Blank linked graphic	खाली लिंक की हुयी सुचित्र
Blank linked graphics	खाली लिंक की हुयी सुचित्र
blank page	खाली पृष्ठ
Blank Slide	खाली स्लइड
Blank template	खाली नमूना
Blind Copy	ब्लइन्ड प्रतिलिपि
Blind copy	ब्लइन्ड प्रतिलिपि
Blind Copy to	केलिए ब्लइन्ड प्रतिलिपि
Blink	टिमटिमाहट
Blinking	टिमटिमाहट करते हुए
Block Elements	ब्लॉक ऐलिमेन्ट्
Blue	नीला
Blue gray	नीला ग्रे
Bold	मोटा
Bold (thickness)	मोटा (घना)
Bold Font	मोटा अक्षर
Bold Italic	मोटा ढेड़ा
bold off	मोटा बंद
bold on	मोटा शुरू
Bold strikethrough	मोटा काटकर निकालना
Bolivia	बोलिविया
Book	पुस्तक
Book excerpt	पुस्तक
Book title	पुस्तक का शीर्षक
Bookmark	पृष्ठसंकेत
Bookmark file	पृष्ठसंकेत फाइल
Bookmark folder	पृष्ठसंकेत कोष्ठ
Bookmark Menu	पृष्ठसंकेत मेनु
Bookmark path	पृष्ठसंकेत मार्ग
Bookmark subscription	पृष्ठसंकेत चन्दा
Bookmarks	पृष्ठसंकेत
Boolean AND	बूलियन AND
Boolean And	बूलियन ऐन्ड
Boolean NOT	बूलियन NOT
Boolean Not	बूलियन नोट्
Boolean Or	बूलियन ओर
Boolean OR	बूलियन OR
Boolean Value	बूलियन मूल्य
Boolean Xor	बूलियन एक्सोर
Bopomofo	बोपोमोफो
Bordeaux	बोर्डयक्स
Border	किनारा
Border / Background	किनारा / पृष्ठभाग
Border Color	किनारे की रंग
Border Style	किनारे की शैली
Borders	किनारें
Bosnia and Herzegowina	बोस्निया और हर्जेगोविना
Bottom	नीचे
bottom	नीचे
Bottom Left	नीचे बायाँ ओर
Bottom margin	नीचे की पृष्ठ-प्रान्त
Bottom of baseline	आधाररेखा की नीचे
Bottom of character	अक्षर की नीचे
Bottom of line	रेखा की नीचे
Bottom Right	नीचे दाहिनी ओर
Bottom to Top	नीचे से ऊपर
Bound column	बँधा हुआ स्तंभ
Box Drawing	बॉक्स रेखाचित्र
Braces	कोष्ठक
Braces (scalable)	कोष्ठक (नापने योग्य)
Braces bottom (scalable)	कोष्ठक नीचे (नापने योग्य)
Braces top (scalable)	कोष्ठक ऊपर (नापने योग्य)
Brackets	कोष्ठक
Brand	व्यापारिक चिन्ह
Brazil	ब्रेजिल
Break	खण्डन
Break Link	कड़ी की खण्डन
Breakpoint	खण्डन बिन्दु
Breakpoint On/Off	खण्डन बिन्दु शुरु/बंद
Breakpoints	खण्डन बिन्दु
Breaks	खण्डन
Breve	लघु स्वर का चिह्न
Brightness	चमकीलापन
Brightness / Contrast	चमकीलापन / भेद दिखलाना
Brightness and contrast	चमकीलापन और भेद दिखलाना
Brightness Contrast	चमकीलापन भेद दिखलाना
Brightness/Contrast	चमकीलापन / भेद दिखलाना
Bring along	साथ लाना
Bring Forward	आगे की ओर लाना
Bring To Front	सामने लाना
Bring to Front	सामने लाना
Brochure	छोटी पुस्तक
Brochures	छोटी पुस्तक
broken line	टूटा हुआ रेखआ
Brown	भूरा
Brownstone	ब्रउनस्टोन
Browse	ब्रउज़
Browse Backward	पिछली ओर ब्रउज़ करो
Browse Forward	आगे की ओर ब्रउज़ करो
Browser	ब्रउज़र
Browser identification	ब्रउज़र का पहचान
Browser Options	ब्रउज़र विकल्प
Brush	ब्रश
B-Spline	B-स्प्लैन
B-Spline with Symbols	संकेत सहित B-स्प्लैन
Bulgaria	बल्गेरिया
Bulgarian	बल्गेरियन
Bullet	बुल्लेट्
Bullet Symbols	बुल्लेट् संकेत
Bullets	बुल्लेट्स
Bullets and Numberings	बुल्लेट्स और संख्या देना
Bullets on/off	बुल्लेट्स शुरु/बंद
Bullets replaced	प्रतिस्थापित बुल्लेट्स
Business	व्यवहार
Business data	व्यवहार ड़ॉटा
Business letter	व्यवहार पत्र
Busy	कार्य में निरत
Button	बटन
Button type	बटन वर्ग
Buttons	बटन
BW Preview	BW पूर्वदृश्य
by	से
By	से
By author	लेखक से
Byelorussian	बइलोरशियन
Byte	बइट्
Bytes	बइट्स
Cache	कॉश
Calculate	गणना करना
Calculate Selection	चुनाव की गणना करो
Calculate subtotals for	केलिए आधा जोड़ की गणना
Calculate Table	सारणी गणना करो
Calculates the covariance.	कोवेरिऐन्स को गणना करता है ।
calculating	गणना करना
Calculation	गणना
Calculation template group	गणना नमूने की वर्ग
Calendar	केलन्डर
Calendar URL	केलन्डर URL
Call Database Manager	कॉल लेखासंचय प्रबन्धक
Call Stack	कॉल स्टॉक
Callout	कॉलौट्
Callout attributes	कॉलौट् ऐट्रिब्यूट्स
Callout type	कॉलौट् वर्ग
Callouts	कॉलौट्स
Calls	कॉल्स
Camera	कॉमेरा
Camera position	कॉमेरा स्थान
Cameroon	कॉमेरून
Canada	केनडा
Canadan Aboriginal Syllables	केनडन स्वदेशीय शब्दांश
Cancel	रद्द करो
cancel	रद्द करो
Cancel Autopilot	ओटोपैलट् रद्द करो
Canceled by user	उपभोक्ता से रद्द की हुयी
Cannot open document.	लेखपत्र को खोल नहीं सकते है ।
Cannot sort selection	चुनाव को सोर्ट नहीं कर सकते है
Cannot transfer data	ड़ॉटा को स्थानान्तर नहीं कर सकते है
Can't open directory	डैरक्टरी को खोल नहीं सकते है
Can't open file	फाइल को खोल नहीं सकते है
Can't Redo	रि-डू नहीं कर सकते है
Can't Restore	पूर्व अवस्था में नहीं पहुँचा सकते है
Can't Revoke	रद्द नहीं कर सकते है
Can't Undo	अनावृत्ति नहीं कर सकते है
Capital Roman	रोमन बड़ा अक्षर
Capital words	बड़ा अक्षर की शब्दें
Capitalization error	बड़ा अक्षर सम्बन्धित गलती
Capitals	बड़ा अक्षर
Caps	बड़ा अक्षर
Caption	कॉप्शन
Caption Characters	कॉप्शन अक्षरें
Caption Text	कॉप्शन टेक्स्ट्
Captions	कॉप्शन
Cascade	संयुक्त करना
Cascade Windows	विन्डों को संयुक्त करना
Case match	केस तुलना
Case sensitive	केस सचेतन
Catalan	केटलॉन
Catalog	सूचीपत्र
Categories	समान वर्ग
Category	समान वर्ग
Category and Number	समान वर्ग और संख्या
Catenate	श्रृंखला के समान बाँधना
Cayman Islands	केमॉन अइलॉन्ड
CC	CC
CDE-Calendar-File	CDE-केलन्डर-फाइल
CD-ROM drive	CD-ROM ड्रइव्
CEILING	CEILING
Cell	कोष्ठ
Cell Attributes	कोष्ठ की ऐट्रिब्यूट्स
Cell Contents	कोष्ठ की विषय
Cell pop-up menu	कोष्ठ पाप्-अप् मेनु
Cell Protection	कोष्ठ रक्षा
Cell Style	कोष्ठ शैली
Cell Styles	कोष्ठ शैलियाँ
Cell value is	कोष्ठ मूल्य
Cells	कोष्ठ
Center	मध्यभाग
Center %O	%O मध्यभाग में
Center Area	मध्यभाग विस्तीर्ण
Center arrowend	तीर की अंत मध्यभाग में
Center arrowhead	तीर की प्रारंभ मध्यभाग में
Center dots	बिन्दी मध्यभाग में
Center Horizontal	समतल मध्यभाग में
Center of baseline	आधररेखा की मध्यभाग
Center of character	अक्षर की मध्यभाग
Center of line	रेखा की मध्यभाग
Center X	X मध्यभाग में
Center Y	Y मध्यभाग में
centered	केन्द्रित
Centered	केन्द्रित
Centered horizontally	समतल प्रकार से केन्द्रित
Centered vertically	लंबरूप प्रकार से केन्द्रित
Centimeter	सेंटीमीटर
Central African Republic	केन्द्रीय ऑफ्रिकन प्रजातंत्र
Certificate Issuer	प्रमाणपत्र देनेवाला
Change %O	%O बदलो
Change Anchor	जोड़ बदलो
Change Database	लेखासंचय बदलो
Change Database Range	लेखासंचय फैलाव बदलो
Change Font	फॉन्ट बदलो
Change mode	प्रकार बदलो
Change name	नाम बदलो
Change page number	पृष्ठ संख्या बदलो
Change password	कूटशब्द बदलो
Change Password	कूटशब्द बदलो
Change password protection	कूटशब्द रक्षा बदलो
Change Position	स्थान बदलो
Change Scale	स्केल बदलो
Change slides manually	स्लइडों को हाथ से बदलो
Changed attribute	बदला हुआ ऐट्रिब्यूट्
Changed contents	बदला हुआ विषय
Changed to	में बदला
Changes	बदला
Changes discovered	परिवर्तनों को आविष्कार किया
Changes rejected	परिवर्तनों को अस्वीकार किया
Channel subscription	चैनल सबस्क्रिप्शन
Chapter	अध्याय
Chapter entry	अध्याय प्रविष्टि
Chapter info	अध्याय सूचना
Chapter name	अध्याय नाम
Chapter no.	अध्याय संख्या
Chapter number	अध्याय संख्या
Chapter Styles	अध्याय शैलियाँ
Chapters	अध्याय
CHAR	CHAR
Character	अक्षर
Character background	अक्षर की पृष्ठभाग
Character set	अक्षर समूह
Character set color	अक्षर समूह की रंग
Character Style	अक्षर शैली
Character Styles	अक्षर शैलियाँ
Characters	अक्षरें
Charcoal sketch	चारकोल खाका
Charcoal Sketch	चारकोल खाका
Chart	चार्ट
Chart Area	चार्ट विस्तीर्ण
Chart Bar	चार्ट पट्टी
Chart colors	चार्ट रंग
Chart Data	चार्ट ड़ॉटा
Chart Data	चार्ट ड़ॉटा
Chart Floor	चार्ट फ्लोर
Chart mode	चार्ट प्रकार
Chart objects	चार्ट वस्तु
Chart Options	चार्ट विकल्प
Chart title	चार्ट का शीर्षक
Chart Title	चार्ट का शीर्षक
Chart Type	चार्ट वर्ग
Chart Wall	चार्ट वाल
Charts	चार्ट
Check	जाँच करना
Check Box	चेक बॉक्स
Check special regions	विशेष प्रदेशों को जाँच करो
Check spelling	शब्द-विन्यास जाँच करो
Check your entries	आपका प्रविष्टियों को जाँच करो
Checkered	चेक्केर्ड
Checkered diagonal	चेक्केर्ड कर्ण
Checking Ports	जाँच करने की पोर्ट्
Cherokee	चेरोकी
CHIDIST	CHIDIST
CHIINV	CHIINV
Chile	चिली
China	चैना
Chinese	चैनीस
Chinese (HongKong)	चैनीस (हान्कांग)
Chinese (simlpe)	चैनीस (सामान्य)
Chinese (Singapore)	चैनीस (सिन्गापुर)
Chinese (Trad.)	चैनीस (परम्परागत)
CHITEST	CHITEST
CHOOSE	CHOOSE
Choose	चुनो
Choose a variant	वेरिऐन्ट चुनो
Choose help file	सहायता फाइल चुनो
Choose Themes	विषय चुनो
Choose your pages	आपकी पृष्ठों को चुनिए
Chrome	क्रोम
CI	CI
Circle	वृत्त
Circle Arc	वृत्त चाप
Circle attributes	वृत्त की ऐट्रिब्यूट्स
Circle Pie	वृत्त पई
Circle Pie, unfilled	वृत्त पई, न भरा हुआ
Circle sector	वृत्त खण्ड
Circle sectors	वृत्त खण्ड
Circle Segment	वृत्त भाग
Circle segment	वृत्त भाग
Circle Segment, unfilled	वृत्त भाग, न भरा हुआ
Circle segments	वृत्त खण्ड
Circle, unfilled	वृत्त, न भरा हुआ
Circles	वृत्त
Circumflex	सर्कमफ्लेक्स
City	नगर
City/State/Zip	नगर/राज्य/Zip
CJK Compatibility	CJK योग्य
CJK Compatibility Forms	CJK के योग्य फ़ॉर्म
CJK Compatibility Ideographs	CJK के योग्य कल्पना केलिए विशिष्ट संकेत
CJK Miscellaneous	CJK मिलावट
CJK Unified Ideographs	CJK एकरूप की कल्पना केलिए विशिष्ट संकेत
Class	वर्ग
Class ID	वर्ग ID
Class Location	वर्ग स्थान
Class path	वर्ग मार्ग
classes	वर्ग
Classic	अत्युत्तम
CLEAN	CLEAN
Clear	सफाई
Clear Cache	कॉश की सफाई
Clear Disk Cache	डिस्क कॉश की सफाई
Clear disk cache	डिस्क कॉश की सफाई
Clear Memory Cache	मेमरी कॉश की सफाई
Clear Outline	बाहरी रूपरेखा की सफाई
Clear Print Range	छपाई फैलाव की सफाई
Clear query	जानकारी की सफाई
Click object	वस्तु में क्लिक करना
Client	ग्राहक
Clipart	क्लिपआर्ट
Cliparts	क्लिपआर्ट
Clipboard ID	क्लिपबोर्ड ID
Close	बन्द करो
Close Active Window	क्रियाशील विन्डो को बन्द करो
Close All	सब बन्द करो
Close All Files	सब फाइलों को बन्द करो
Close All Windows	सब विन्डों को बन्द करो
Close Application	कार्यक्रम बन्द करो
Close Document	लेखपत्र को बन्द करो
Close Horizontally	समतल प्रकार से बन्द करो
Close mail	मेइल को बन्द करो
Close Object	वस्तु को बन्द करो
Close Polygon	बहुभुज को बन्द करो
Close Task	कार्य को बन्द करो
Close Vertically	लंबरूप प्रकार से बन्द करो
Close Window	विन्डो को बन्द करो
Closed Circle	बन्द की हुयी वृत्त
Closed Circle II	बन्द की हुयी वृत्त II
Closing folder	बन्द किये जानेवाला कोष्ठ
CMYK	CMYK
Coarse grained	कोएर्स ग्रेइनड
CODE	CODE
Col	स्तंभ
Collapse	सिकुडना
Collate	विस्तारपूर्वक तुलना करना
Collect suggestions	सुझाव संग्रह करना
Collect suggestions	सुझाव संग्रह करना
Colombia	कोलम्बिया
Color	रंग
Color Bar	रंग पट्टी
Color Depth	रंग की गहराई
Color format	रंग की रचना
Color Palette	रंग की पटिया
Color Preview	रंग की पूर्वदृश्य
Color required	रंग की आवश्यकता
Color resolution	रंग विश्लेषण
Color Resolution	रंग विश्लेषण
Color sample	रंग की नमूना
Color selection	रंग की चुनाव
Colored tab controls	रंगीन टॉब नियंत्रण
Colors	रंग
Colors for changes	परिवर्तनों केलिए रंग
Column	स्तंभ
Column $(N)	स्तंभ $(N)
Column Arrangement	स्तंभ को क्रम में रखना
Column Break	स्तंभ खण्डन
Column break	स्तंभ खण्डन
Column configuration	स्तंभ की रूपरेखा
Column deleted	स्तंभ को मिटाया
Column Format	स्तंभ का रचना
Column headers	स्तंभ का शीर्षक
Column Information	स्तंभ का सूचना
Column information	स्तंभ का सूचना
Column input cell	स्तंभ इनपुट् कोष्ठ
Column inserted	स्तंभ को जोड़ा
Column name	स्तंभ का नाम्
Column names	स्तंभ का नाम्
Column not found	स्तंभ नहीं मिला
Column oriented	स्तंभ अनुस्थापित
Column properties	स्तंभ विशेषतायें
Column Properties	स्तंभ विशेषतायें
Column spacing	स्तंभ का अंतर देना
Column Width	स्तंभ चौड़ाई
Column width	स्तंभ चौड़ाई
Column widths	स्तंभ चौड़ाई
Column Widths	स्तंभ चौड़ाई
Column Wrap	स्तंभ लपेटना
Column/Row headers	स्तंभ/पंक्ति शीर्षक
Column/Row Headers On/Off	स्तंभ/पंक्ति शीर्षक शुरु/बंद
Columns	स्तंभें
COLUMNS	COLUMNS
COMBIN	COMBIN
COMBINA	COMBINA
Combination	मिलाव
Combine	मिलाओ
Combine identical entries	समान प्रविष्टियों को मिलाओ
Combine paragraphs	परिच्छेदों को मिलाओ
Combine with -	सहित मिलाओ -
Combining Diacritical Marks	स्वरों का विशिष्ट चिह्नों को मिलाना
Combining Diacritical Symbols	स्वरों का विशिष्ट संकेतों को मिलाना
Combining Half Marks	आधा चिह्नों को मिलाना
Combo Box	कॉम्बो बॉक्स
Combo Box Field_	कॉम्बो बॉक्स क्षेत्र_
Comma	छोटे विराम का चिह्न
Command Button	निर्देश बटन
Command mode	निर्देश प्रकार
Command successfully executed.	निर्देश सफलता से पूर्ण हुआ ।
Commands	निर्देश
Comment	अपवाद
Comments	अपवाद
Company	संस्था
Compare	तुलना
Compare Document	लेखपत्र को तुलना करो
Compare Documents	लेखपत्रों को तुलना करो
Compare documents	लेखपत्रों को तुलना करो
Comparison aborted.	तुलना अधूरा रह गया
Compatibility	योग्य
Compile	कम्पैल
Compile Error	कम्पैल गलती
Compiling help files	सहायता फाइलों को कम्पैल कर रहा है
Complete	सम्पूर्ण
Complete Directory	सम्पूर्ण डैरक्टरी
Complete words	सम्पूर्ण शब्द
Complex Numbers Set	जटिल संख्या समूह
Component resized	कॉम्पोनेन्ट को नया परिमाण दिया है
Component shown	दिखाया हुआ कॉम्पोनेन्ट
components listed below.	निम्नलिखित कॉम्पोनेन्ट
Compressed	दबाया हुआ
Compressed display	दबाकर प्रदर्शन
Compression	दबाव
Compression value	दबाव मूल्य
CONCATENATE	CONCATENATE
Concordance file	सादृश्य फाइल
Condensed	संक्षिप्त
Condition	शर्त लगाना
Conditional Formatting	शर्त लगाकर रचना करना
Conditional Style	शर्त के अन्तर्गत शैली
Conditional Styles	शर्त के अन्तर्गत शैलियाँ
Conditional text	शर्त के अन्तर्गत टेक्स्ट्
Cone	शंकु
Cones	शंकु
Cones, deep	शंकु, गहरा
Cones, percent	शंकु, प्रतिशत
Cones, stacked	शंकु, स्टॉक की हुयी
Conference proceedings	सम्मेलन कृति
Conference report	सम्मेलन रिपोर्ट
CONFIDENCE	CONFIDENCE
Confidential	विश्वस्त
Confidentiality level	विश्वासपूर्वक सतह
Configuration	रूप-रेखा
Configuration (Insert Header/Footer)	रूप-रेखा (पृष्ठ के ऊपर की टीका/नीचे की टीका जोड़ो)
Configuration file	रूप-रेखा फाइल
Configuration Menu	रूप-रेखा मेनु
Configuration Server	रूप-रेखा सर्वर
Configurations	रूप-रेखा
Configure	रूप-रेखा दो
Confirm	दृढ़ करो
Confirm Delete	मिटाना दृढ़ करो
Confirm delete	मिटाना दृढ़ करो
Confirm file replacement	फाइल प्रतिस्थापना को दृढ़ करो
Confirm Overwrite	ओवररैट् को दृढ़ करो
Confirm password	कूटशब्द को दृढ़ करो
Confirm receipt	स्वीकृति को दृढ़ करो
Connect	कनेक्ट
Connecting to $(ARG1)	$(ARG1) को कनेक्ट कर रहा है
Connecting with %1	%1 सहित कनेक्ट कर रहा है
Connection	कनेक्शन
Connection failed	कनेक्शन असफल हुआ
Connection failure	कनेक्शन में असफलता
Connection Lines	कनेक्शन रेखाएँ
Connection lost	कनेक्शन नष्ट हुआ
Connection mode	कनेक्शन प्रकार
Connector	कनेक्टर
Connector attributes	कनेक्टर ऐट्रिब्यूट्स
Connector reserved 2	कनेक्टर 2 केलिए रक्षित
Connector reserved 3	कनेक्टर 3 केलिए रक्षित
Connector reserved 4	कनेक्टर 4 केलिए रक्षित
Connector reserved 5	कनेक्टर 5 केलिए रक्षित
Connector reserved 6	कनेक्टर 6 केलिए रक्षित
Connector reserved 7	कनेक्टर 7 केलिए रक्षित
Connector reserved 8	कनेक्टर 8 केलिए रक्षित
Connector reserved 9	कनेक्टर 9 केलिए रक्षित
Connector with Arrows	तीर सहित कनेक्टर
Connector with Circles	वृत्त सहित कनेक्टर
Connectors	कनेक्टरें
Consecutive numbering	क्रमागत संख्या देना
Consolidate	एक करना
Consolidate by	से एक करना
Consolidate Data	ड़ॉटा को एक करना
Consolidation areas	एकीकरण विस्तीर्ण
Constant $(ARG1) redefined	स्थिर $(ARG1) को फिर से परिभाषा किया है
Constant value	स्थिर मूल्य
Contains	सम्मिलित
Contains column headers	स्तंभ शीर्षकों को सम्मिलित
Contains row headers	पंक्ति शीर्षकों को सम्मिलित
Content	विषय
Content Type	विषय वर्ग
Content View	विषय दृश्य
Contents	विषयसूची
Contents 1	विषयसूची 1
Contents Heading	विषयसूची
Contents not protected	विषयसूची रक्षित नहीं है
Contents protected	विषयसूची रक्षित
Context	सन्दर्भ
Continuation notice	विस्तृत सूचना
Continuation page	विस्तृत पृष्ठ
Continuation page number	विस्तृत पृष्ठ संख्या
Continuation pages	विस्तृत पृष्ठ
Continue	जारी रखो
Continue search backwards	पिछली ओर खोज जारी रखो
Continue search forward	आगे की ओर खोज जारी रखो
Continuous	निरन्तर
Contour	परिवेश
Contour Dialog	परिवेश डयलॉग
Contour Editor	परिवेश संपादक
Contour mode	परिवेश प्रकार
Contour Mode	परिवेश प्रकार
Contrast	भेद बतलाना
Control	नियंत्रण
Control Bar	नियंत्रण पट्टी
Control message	नियंत्रण सन्देश
Control Password	नियंत्रण कूटशब्द
Control Pictures	नियंत्रण चित्र
Control Properties	नियंत्रण विशेषतायें
Control user	उपभोक्ता नियंत्रण
Control User name	उपभोक्ता की नाम् नियंत्रण करो
Controls	नियंत्रण
Controls Toolbar	औज़ार पट्टी की नियंत्रण
Convened by	से इकट्ठा की हुयी
Convert	बदलो
CONVERT	CONVERT
Convert Polygon segment	बहुभुज भाग को बदलो
Convert Table/Text	सारणी/टेक्स्ट् बदलो
Convert to bitmap	बिटमॉप् में बदलो
Convert to contour	परिवेश में बदलो
Convert to Curve	वक्र केलिए बदलो
Convert to Curve	वक्र केलिए बदलो
Convert to Grayscale	ग्रेस्केल केलिए बदलो
Convert to metafile	मेटा फाइल केलिए बदलो
Convert to Polygon	बहुभुज में बदलो
Converting	बदल रहा है
Converting the documents	लेखपत्र को बदल रहा है
Cookies	कुकीस
Copies	प्रतिलिपियाँ
Coproduct	कोप्रोडक्ट
Copy	प्रतिलिपि
Copy back	प्रतिलिपि
Copy entire sheet	सम्पूर्ण शीट् की प्रतिलिपि
Copy Graphics	सुचित्रों की प्रतिलिपि
Copy heading	शीर्षक की प्रतिलिपि
Copy HTML table	HTML सारणी की प्रतिलिपि
Copy Link	कड़ी की प्रतिलिपि
Copy list from	से सूची की प्रतिलिपि
Copy page	पृष्ठ की प्रतिलिपि
Copy results to	में नतीजों की प्रतिलिपि
Copy RTF table	RTF सारणी की प्रतिलिपि
Copy Sheet	शीट् की प्रतिलिपि
Copy structure	बनावट का प्रतिलिपि
Copy table	सारणी का प्रतिलिपि
Copy to	में प्रतिलिपि
Copy to folder	कोष्ठ में प्रतिलिपि
Copy user files	उपभोक्ता का फाइलें की प्रतिलिपि
Copy values only	केवल मूल्य की प्रतिलिपि
Copy while moving	स्थान परिवर्तन के समय प्रतिलिपि
Copy/Move Sheet	शीट् की प्रतिलिपि/स्थान परिवर्तन
Copy/Move to	को प्रतिलिपि/स्थान परिवर्तन
Copying data	ड़ॉटा की प्रतिलिपि करना
Copying in progress	प्रतिलिपि करना जारी है
Corner	कोना
Corner Point	कोने का बिन्दु
Corner Radius	कोने का व्यासाध
Corner radius	कोने का व्यासाध
CORREL	CORREL
COSH	COSH
Cosine	कोटिज्या
Cost	मूल्य
Costa Rica	कोस्टा रिका
Cotangent	कोटान्जेन्ट
Cote d'Ivoire	कोट डि अइवोइर
COTH	COTH
Count	गिनती
Count (Numbers only)	गिनती (केवल संख्या)
Count lines	रेखाओं को गिनना
Count_1	गिनती_1
Count_2	गिनती_2
COUNTA	COUNTA
CountA	गिनतीA
COUNTBLANK	COUNTBLANK
COUNTIF	COUNTIF
counting records	अभिलेखों को गिनना
Country	देश
Country	देश
Country/State	देश/राज्य
Country/Zip/City	देश/Zip/नगर
COVAR	COVAR
Cover open	ढकना खोलो
CPU	CPU
CR	CR
CR LF	CR LF
CRC Check	CRC जाँच
Create	उत्पन्न करो
Create AutoAbstract	स्वचालित उपसंक्षेप को उत्पन्न करो
Create backup	बैकप उत्पन्न करो
Create Control	नियंत्रण उत्पन्न करो
Create DataPilot Table	ड़ॉटापैलट् सारणी उत्पन्न करो
Create Directory	डैरक्टरी उत्पन्न करो
Create Document	लेखपत्र उत्पन्न करो
Create extrusion object	निष्कासन वस्तु उत्पन्न करो
Create FontWork object	फ़ॉन्टवर्क वस्तु उत्पन्न करो
Create Form	फ़ॉर्म उत्पन्न करो
Create from	से उत्पन्न करो
Create from file	फाइल से उत्पन्न करो
Create Group	समूह उत्पन्न करो
Create HTML Document	HTML लेखपत्र उत्पन्न करो
Create index for	केलिए अनुक्रमणी उत्पन्न करो
Create Link	कड़ी उत्पन्न करो
Create Master Document	प्रधान लेखपत्र को उत्पन्न करो
Create name from	से नाम उत्पन्न करो
Create Names	नामों को उत्पन्न करो
Create new	नया उत्पन्न करो
Create new folder	नया कोष्ठ उत्पन्न करो
Create new section	नया विभाग उत्पन्न करो
Create new template	नया नमूना उत्पन्न करो
Create primary key	प्रैमरी की उत्पन्न करो
Create rotation object	घुमाव वस्तु उत्पन्न करो
Create Scenario	विवरण उत्पन्न करो
Create slides	स्लइडों को उत्पन्न करो
Create Style	शैली उत्पन्न करो
Create summary	सारांश उत्पन्न करो
Create table	सारणी उत्पन्न करो
Create table element	सारणी ऐलिमेन्ट् उत्पन्न करो
Create target directory	लक्ष्य डैरक्टरी उत्पन्न करो
Create template	नमूना उत्पन्न करो
Create title page	शीर्षक पृष्ठ को उत्पन्न करो
Create\nPreview	पूर्वदृश्य\nउत्पन्न करो
Created	उत्पादित
Created by	से उत्पादित
Created on	में उत्पादित
Creating abstract	उपसंक्षेप उत्पन्न कर रहा है
Creating directories	डैरक्टरी को उत्पन्न कर रहा है
Creating local settings	स्थानिक निर्धारण उत्पन्न कर रहा है
Creative Labs Audio	उत्पादक लाब्स आडियो
CRITBINOM	CRITBINOM
Criteria	सिद्धान्त
criteria	सिद्धान्त
Croatia	क्रोवेशिया
Croatian	क्रोवेशियन
Crop	क्रॉप
Crossed	कटा हुआ
Cross-fade attributes	क्रॉस-फ़ेड ऐट्रिब्यूट्स
Cross-fade effect	क्रॉस-फ़ेड प्रभाव
Cross-Fade from Bottom	नीचे से क्रॉस-फ़ेड
Cross-Fade from Left	बायाँ ओर से क्रॉस-फ़ेड
Cross-Fade from Right	दाहिनी ओर से क्रॉस-फ़ेड
Cross-Fade from Top	ऊपर से क्रॉस-फ़ेड
Cross-fading	क्रॉस-फ़ेड करना
Cuba	क्यूबा
Cube	घन
Cubic Spline	घनाकार स्प्लैन
CUMIPMT	CUMIPMT
CUMPRINC	CUMPRINC
Currencies	मुद्रा
Currency	मुद्रा
Currency 3D	मुद्रा 3D
Currency Field	मुद्रा क्षेत्र
Currency Gray	मुद्रा ग्रे
Currency Lavender	मुद्रा लॉवेन्डर
Currency ranges	मुद्रा फैलाव
Currency symbol	मुद्रा संकेत
Currency Symbols	मुद्रा संकेत
Currency Turquoise	मुद्रा टर्कोइस
CURRENT	CURRENT
Current Basic Module	वर्तमान मूलभूत मोड्यूल
Current Context	वर्तमान सन्दर्भ
Current Database	वर्तमान लेखासंचय
Current Date	वर्तमान दिनांक
Current document only	केवल वर्तमान लेखपत्र
Current Index	वर्तमान अनुक्रमणी
Current Library	वर्तमान लैब्ररी
Current Section	वर्तमान विभाग
Current selection	वर्तमान चुनाव
Current selection only	केवल वर्तमान चुनाव
Current Style:	वर्तमान शैली:
Current Time	वर्तमान समय
Current version	वर्तमान आवर्तन
Cursor	कर्सर
Cursor type	कर्सर वर्ग
Curve	वक्र
Curve Integral	पूरा वक्र
Curve objects	वक्र वस्तु
Curve, filled	वक्र, भरा हुआ
Curved Connector	वक्राकार कनेक्टर
Curves	वक्र
Custom dictionaries	शब्दकोश व्यवस्था करो
Custom fonts	फ़ॉन्ट को व्यवस्था करो
Custom format	रचना को व्यवस्था करो
Custom heading	शीर्षक को व्यवस्था करो
Custom Installation	प्रतिष्ठापन व्यवस्था करो
Custom Quotes	क्वोट्स व्यवस्था करो
Custom Size	परिमाण को व्यवस्था करो
Custom Slide Show	स्लइड प्रस्तुति को व्यवस्था करो
Custom Slide Shows	स्लइड प्रस्तुति को व्यवस्था करो
Custom sort order	सोर्ट क्रम व्यवस्था करो
Custom Styles	शैलियों को व्यवस्था करो
Customer No.	ग्राहक संख्या
Customer number	ग्राहक संख्या
Customize	व्यवस्था करो
Customize Buttons	बटनों को व्यवस्था करो
Customize Toolbars	औजार पट्टियों को व्यवस्था करो
CustomizeToolbars	औजार पट्टियों को व्यवस्था करो
Cut	काटो
Cyan	सियान
Cycle	पूर्तिकाल
Cylinder	वर्तुलाकार
Cylinder, deep	वर्तुलाकार, गहरा
Cylinder, percent	वर्तुलाकार, प्रतिशत
Cylinder, stacked	वर्तुलाकार, स्टॉक की हुयी
Cyprus	साइप्रस
Cyrillic	सिरिलिक
Czech	चेक्
Czech Republic	चेक् रिपब्लिक
Daisy	डैसी
Danish	डॉनिश
Dark violet	गहरा नीला
Dash	डॉश
Dash (Bold)	डॉश (मोटा)
Dashed (variable)	डॉश (परिवर्तनीय)
Dashes	डॉश
Dashes and dots	डॉश और बिन्दी
Data	ड़ॉटा
DATA	DATA
Data Area	ड़ॉटा विस्तीर्ण
Data column symbol	ड़ॉटा स्तंभ संकेत
Data columns label	ड़ॉटा स्तंभ लेबिल
Data Field	ड़ॉटा क्षेत्र
Data for [	[ केलिए ड़ॉटा
Data in Columns	स्तंभों की ड़ॉटा
Data in Rows	पंक्तियों की ड़ॉटा
Data increment (MB)	ड़ॉटा बढती (MB)
Data into Fields	क्षेत्रों में ड़ॉटा
Data into Text	टेक्स्ट् में ड़ॉटा
Data Labels	ड़ॉटा लेबिलें
Data labels	ड़ॉटा लेबिलें
Data Pilot Tables	ड़ॉटा पैलट सारणी
Data Point	ड़ॉटा बिन्दु
Data points order	ड़ॉटा बिन्दी क्रम
Data Range	ड़ॉटा फैलाव
Data rows label	ड़ॉटा पंक्ति लेबिल्
Data Series	ड़ॉटा श्रृंखला
Data series in	में ड़ॉटा श्रृंखला
Data series symbol	ड़ॉटा श्रृंखला संकेत
Data Source	ड़ॉटा मूल
Data source	ड़ॉटा मूल
Data Source Administration	ड़ॉटा मूल प्रशासन
Data source URL	ड़ॉटा मूल URL
Data sources	ड़ॉटा मूल
Data Sources	ड़ॉटा मूल
Data to Fields	क्षेत्रों में ड़ॉटा
Data to Text	टेक्स्ट् में ड़ॉटा
Data type mismatch	भिन्न ड़ॉटा वर्ग
Data_1	ड़ॉटा_1
Data_2	ड़ॉटा_2
Data_B	ड़ॉटा_B
data_E	ड़ॉटा_E
data_X	ड़ॉटा_X
data_Y	ड़ॉटा_Y
Database	लेखासंचय
Database bar	लेखासंचय पट्टी
Database columns	लेखासंचय स्तंभ
Database content	लेखासंचय विषय
Database Converter	लेखासंचय बदलनेवाला
Database Field	लेखासंचय क्षेत्र
Database field	लेखासंचय क्षेत्र
Database fields	लेखासंचय क्षेत्र
Database File	लेखासंचय फाइल
Database file	लेखासंचय फाइल
Database files	लेखासंचय फाइलें
Database Name	लेखासंचय नाम्
Database names	लेखासंचय नाम्
Database password	लेखासंचय कूटशब्द
Database Queries	लेखासंचय जानकारीें
Database Ranges	लेखासंचय फैलाव
Database selection	लेखासंचय चुनाव
Database settings	लेखासंचय निर्धारण
Database size (MB)	लेखासंचय परिमाण (MB)
Database sizes	लेखासंचय परिमाण
Database Statistics	लेखासंचय अँकडे
Database Table	लेखासंचय सारणी
Database type	लेखासंचय वर्ग
Databases	लेखासंचय
Databases in Use	उपयोग में रहनेवाले लेखासंचय
Databuffer size (MB)	ड़ॉटा बफर परिमाण (MB)
DATADEVSPACE	DATADEVSPACE
DataPilot	ड़ॉटा पैलट्
DataPilot Category	ड़ॉटा पैलट् वर्ग
DataPilot Corner	ड़ॉटा पैलट् कोना
DataPilot Field	ड़ॉटा पैलट् क्षेत्र
DataPilot pop-up menu	ड़ॉटा पैलट् पाप-अप मेनु
DataPilot Result	ड़ॉटा पैलट् नतीजा
DataPilot Title	ड़ॉटा पैलट् का शीर्षक
DataPilot Value	ड़ॉटा पैलट् मूल्य
Date	दिनांक
DATE	DATE
Date (fixed)	दिनांक (स्थिर)
Date (variable)	दिनांक (परिवर्तनीय)
Date 1	दिनांक 1
Date 2	दिनांक 2
Date and time	दिनांक और समय
Date Field	दिनांक क्षेत्र
Date format	दिनांक रचना
Date max.	अधिकतम दिनांक
Date min.	न्यूनतम दिनांक
Date modified	सुधार किया हुआ दिनांक
Date time	दिनांक समय
Date Time Author	दिनांक समय लेखक
DATE	DATE
Date_1	दिनांक_1
Date_2	दिनांक_2
DateTime	दिनांक एवं समय
DATEVALUE	DATEVALUE
DAVERAGE	DAVERAGE
Day	दिन
DAY	DAY
day(s)	दिन
Days	दिन
days	दिन
DAYS	DAYS
DAYS360	DAYS360
DaysInMonth	महीने में दिन
DaysInYear	वर्ष में दिन
DB	DB
DB2	DB2
dBase	dBase
DBase export	dBase निर्यात
dBase;*.dbf	dBase;*.dbf
DCOUNT	DCOUNT
DCOUNTA	DCOUNTA
DDB	DDB
DDE	DDE
DDE automatic	DDE स्वचालित
DDE channel locked	DDE चेनल ताला लगा हुआ
DDE Command	DDE निर्देश
DDE Error	DDE गलती
DDE field	DDE क्षेत्र
DDE link	DDE कड़ी
DDE link	DDE कड़ी
DDE manual	DDE मानुवल
DDE Statement	DDE वाक्य
Deactivate	निष्क्रिय करो
Deactivate Document	लेखपत्र निष्क्रिय करो
Deactivate for	केलिए निष्क्रिय करो
Dealer	व्यापारी
Dec	दिसम्बर
December	दिसम्बर
Decimal	दशांश
Decimal	दशांश
Decimal accuracy	दशांश शुद्धता
Decimal places	दशांश स्थान
Decimal separator	दशांश अलगानेवाला
Decimal Symbol	दशांश संकेत
Decorative	सजाया हुआ
Decrease Indent	इन्डेन्ट घटाओ
Decrease Spacing	अंतर घटाओ
Decrement Indent Value	इन्डेन्ट मूल्य घटाओ
Decrypt/Verify (PGP)	डिक्रिप्ट्/प्रमाणित करो (PGP)
Deep	गहरा
Default	अनुपस्थिति
Default button	अनुपस्थिति बटन
Default Colors	अनुपस्थिति रंग
Default control	अनुपस्थिति नियंत्रण
Default Filter	अनुपस्थिति फिल्टर
Default Fonts	अनुपस्थिति अक्षरें
Default fonts	अनुपस्थिति अक्षरें
Default language	अनुपस्थिति भाषा
Default orientation	अनुपस्थिति अनुस्थापन
Default printer	अनुपस्थिति मुद्रक
Default protocol	अनुपस्थिति प्रोटोकोल
Default selection	अनुपस्थिति चुनाव
Default status	अनुपस्थिति वस्तुस्थिति
Default Templates	अनुपस्थिति नमूनें
Default value	अनुपस्थिति मूल्य
Define	परिभाषा दो
Define Bibliography Entry	ग्रन्थ-सूची प्रविष्टि को परिभाषा दो
Define Database Range	लेखासंचय फैलाव को परिभाषा दो
Define Label Range	लेबिल फैलाव को परिभाषा दो
Define line styles	रेखा शैलियों को परिभाषा दो
Define Names	नामों को परिभाषा दो
Define Print Range	छपाई फैलाव को परिभाषा दो
Define Range	फैलाव को परिभाषा दो
Define Range Names	फैलाव नामों को परिभाषा दो
Define Text Attributes	टेक्स्ट् ऐट्रिब्यूटों को परिभाषा दो
Definition	परिभाषा
Definition and data	परिभाषा और ड़ॉटा
Definition, direct	परिभाषा, सीधा
Degree	डिग्री
degree	डिग्री
DEGREES	DEGREES
degrees	डिग्रियाँ
Degrees	डिग्रियाँ
degrees_freedom	डिग्रीस_स्वतंत्र
degrees_freedom_1	डिग्रीस_स्वतंत्र_1
degrees_freedom_2	डिग्रीस_स्वतंत्र_2
Deinstall	प्रतिष्ठापन हटाओ
Deinstallation	प्रतिष्ठापन हटाना
Delay	अंतराल
Delete	मिटाओ
Delete All	सब मिटाओ
Delete all	सब मिटाओ
Delete all files	सब फाइलों को मिटाओ
Delete AutoFormat	स्वचालित रचना मिटाओ
Delete bitmap	बिटमॉप् मिटाओ
Delete bookmark	पृष्ठसंकेत मिटाओ
Delete cascade	कास्केड मिटाओ
Delete Cells	कोष्ठों को मिटाओ
Delete color	रंग मिटाओ
Delete Column	स्तंभ मिटाओ
Delete column break	स्तंभ खण्डन मिटाओ
Delete Columns	स्तंभों को मिटाओ
Delete Contents	विषयों को मिटाओ
Delete contents	विषयों को मिटाओ
Delete data	ड़ॉटा मिटाओ
Delete Data Source	ड़ॉटा मूल मिटाओ
Delete DataPilot Table	ड़ॉटापैलट् सारणी मिटाओ
Delete directories	डैरक्टरियों को मिटाओ
Delete drawing objects	रेखाचित्र वस्तुओं को मिटाओ
Delete entire column(s)	सम्पूर्ण स्तंभ मिटाओ
Delete entire row(s)	सम्पूर्ण पंक्ति मिटाओ
Delete entry	प्रविष्टि मिटाओ
Delete event entries	घटना प्रविष्टियों को मिटाओ
Delete files	फाइलों मिटाओ
Delete frame	फ्रेम मिटाओ
Delete Frame	फ्रेम मिटाओ
Delete gradient	ग्रेडिऐन्ट् मिटाओ
Delete graphics	सुचित्रों को मिटाओ
Delete Group	समूह मिटाओ
Delete hatching	हॉचिंग मिटाओ
Delete History	हिस्टरी मिटाओ
Delete icon	अइकॉन मिटाओ
Delete Image	चित्र मिटाओ
Delete Index	अनुक्रमणी मिटाओ
Delete Join	जाइन मिटाओ
Delete Layer	परत मिटाओ
Delete layer	परत मिटाओ
Delete line ends	रेखा अंत मिटाओ
Delete line style	रेखा शैली मिटाओ
Delete local settings	स्थानिक निर्धारण मिटाओ
Delete Manual Break	मानुवल खण्डन मिटाओ
Delete Message	सन्देश मिटाओ
Delete numbering	संख्या देना ऑप्शन् मिटाओ
Delete object	वस्तु मिटाओ
Delete options	विकल्प मिटाओ
Delete Page	पृष्ठ मिटाओ
Delete page	पृष्ठ मिटाओ
Delete Page Breaks	पृष्ठ खण्डन मिटाओ
Delete Points	बिन्दुओं को मिटाओ
Delete Record	अभिलेख मिटाओ
Delete Row	पंक्ति मिटाओ
Delete row	पंक्ति मिटाओ
Delete row break	पंक्ति खण्डन मिटाओ
Delete row/column	पंक्ति/स्तंभ को मिटाओ
Delete Rows	पंक्तियों को मिटाओ
Delete section	विभाग को मिटाओ
Delete Section	विभाग को मिटाओ
Delete Selected Design	चुने हुए डिसैन को मिटाओ
Delete Sheet	शीट् को मिटाओ
Delete Sheet Window	शीट् विन्डो को मिटाओ
Delete Sheets	शीटों को मिटाओ
Delete Slide	स्लइड को मिटाओ
Delete slides	स्लइडों को मिटाओ
Delete Snap Line	स्नॉप रेखा को मिटाओ
Delete Snap Point	स्नॉप बिन्दु को मिटाओ
Delete structure	बनावट को मिटाओ
Delete table structure	सारणी बनावट को मिटाओ
Delete unused backgrounds	अनुभ्यस्त पृष्ठभाग को मिटाओ
Delete user	उपभोक्ता को मिटाओ
Deleted	मिटाया
deleted	मिटाया
Deleted Object	मिटाया हुआ वस्तु
Deleting messages	सन्देशों को मिटाना
Deletions	मिटाना
Demote	डिमोट्
Demote Chapter	डिमोट् अध्याय
Demote Level	सतह घटाना
Denmark	डेनमार्क
Denominator	डिनोमिनेटर
Department	विभाग
Depth	गहराई
Descending	अवरोहण क्रम
descending	अवरोहण क्रम
Description	विवरण
Description only	केवल विवरण
Design	डिसैन
Design Mode on/off	डिसैन प्रकार शुरु/बंद
Design view	डिसैन दृश्य
Destination	नियत स्थान
Destination file	नियत स्थान फाइल
Detail View	विस्तारपूर्वक वर्णन दृश्य
Details	विस्तारपूर्वक वर्णन
Detective	जासूसी
Detective Fill Mode	जासूसी भरने का प्रकार
Devanagari	देवनगरि
Device I/O error	साधन की I/O गलती
Device not available	साधन प्राप्य नहीं है
Device used	उपयोग की हुयी साधन
DEVSQ	DEVSQ
DGET	DGET
Diagonal down	कर्ण नीचे
diagonal line	कर्ण रेखा
Diagonal Pen (left)	कर्ण कलम (बायाँ)
Diagonal Pen (right)	कर्ण कलम (दाहिना)
Diagonal up	कर्ण ऊपर
Dialer	डयल करनेवाला
Dialog	डयलॉग
Dialog center	डयलॉग केन्द्र
Diamond	वज्ञ्र
Dictate	आदेश
Dictionaries	शब्दकोश
Dictionary	शब्दकोश
Dictionary Error	शब्दकोश गलती
DIF	DIF
Dif Export	Dif का निर्यात
Dif Import	Dif का आयात
Difference	भिन्नता
Dimension Line	परिमाण रेखा
Dimension line	परिमाण रेखा
Dimension line overhang	परिमाण रेखा ओरहॉन्ग
Dimension line space	परिमाण रेखा अंतर
Dimension lines	परिमाण रेखा
Dimension Lines	परिमाण रेखा
Dimension value format	परिमाण मूल्य की रचना
Dimensioning	परिमाण देना
Dimensioning attributes	परिमाण देने का ऐट्रिब्यूट्
Dimensioning objects	परिमाण देने का वस्तु
Dimensioning reserved 4	परिमाण देना 4 केलिए रक्षित
Dimensioning reserved 5	परिमाण देना 5 केलिए रक्षित
Dimensions	परिमाण
DIN A4 portrait	DIN A4 पोर्टरैट्
DIN A5 landscape	DIN A5 लान्डस्केप्
Dingbats	डिन्गबाट्स
Direct column break	सीधा स्तंभ खण्डन
Direct Cursor	सीधा कर्सर
Direct cursor	सीधा कर्सर
Direct Cursor on/off	सीधा कर्सर शुरु/बंद
Direct line break	सीधा रेखा खण्डन
Direct page break	सीधा पृष्ठ खण्डन
Direction	दिशा
Directories	डैरक्टरियाँ
Directory	डैरक्टरी
Directory and memory	डैरक्टरी और मेमरी
Disassemble	अलगाना
Disassembly	अलगाना
Discard	उपेक्षा
Disconnected	अलग गया
Disk not ready	डिस्क् तैयार नहीं
Display	प्रदर्शन
Display additional information	अतिरिक्त जानकारी प्रदर्शन
Display All	सब प्रदर्शन
Display BlackWhite	कालासफेद दिखाओ
Display border in	किनारे को दिखाओ
Display bullets	बुल्लेट्स दिखाओ
Display Colors	रंगों को दिखाओ
Display Documents	लेखपत्रों को दिखाओ
Display drop caps	बडे अक्षरों को मिटाकर दिखाओ
Display Field	क्षेत्र को दिखाओ
Display Grayscale	ग्रेस्केल को दिखाओ
Display Grid	जाल को दिखाओ
Display HId	HId को दिखाओ
Display IDs	IDs को दिखाओ
Display inactive records	निष्क्रिय अभिलेखों को दिखाओ
Display Plug-Ins	प्लग-ईन् को दिखाओ
Display Properties	स्वभावों को दिखाओ
Display Quality	विशेषता को दिखाओ
display Report	रिपोर्ट प्रदर्शन
Display warning	चेतावनी प्रदर्शन
DisplayHID	HID प्रदर्शन
Dissertation	विवरण
Dissolve	विलीन
Distance	दूरी
Distinct values	अनोखा मूल्य
Distort	रूप बिगाडना
Distribute	वितरण
Distribute selected objects	चुने हुए वस्तुओं के वितरण
Distribution	वितरण
Divide	भाग करो
Dividend	लाभांश
Divides	भाग करना
Division (Fraction)	भागगणित (फ्राक्शन)
Division (Slash)	भागगणित (स्लाश)
Division by zero	शून्य से विभाजन
Divisor	भाजक
DMAX	DMAX
DMIN	DMIN
DNS server	DNS सर्वर
Do Not Delete	मत मिटाओ
do not invert	मत उलटना
Do Not Save	संचित मत करो
Do not use	उपयोग मत करो
Doc Information	लेखपत्र विषय
Doc.Information	लेखपत्र विषय
DocInformation	लेखपत्र विषय
Document	लेखपत्र
Document as E-mail	लेखपत्र E-mail जैसे
Document contents	लेखपत्र विषयसूची
Document Contents	लेखपत्र विषयसूची
Document count	लेखपत्र गिनना
Document Count	लेखपत्र गिनना
Document From Abstract	उपसंक्षेप से लेखपत्र
Document Language	लेखपत्र भाषा
Document Manager	लेखपत्र प्रबन्धक
Document Mode	लेखपत्र प्रकार
Document Modified	लेखपत्र परिवर्तन किया
Document number	लेखपत्र संख्या
Document Options	लेखपत्र विकल्प
Document position	लेखपत्र स्थान
Document properties	लेखपत्र विशेषतायें
Document selection	लेखपत्र चुनाव
Document title	लेखपत्र का शीर्षक
Document view	लेखपत्र दृश्य
Document:	लेखपत्र:
Documents	लेखपत्र
Documents	लेखपत्र
DOLLAR	DOLLAR
Domain	क्षेत्र
Domain user	क्षेत्र उपभोक्ता
Dominican Republic	डोमिनिकन रिपब्लिक
Don't display tips	सुझावों को प्रदर्शन मत करो
Don't execute	मत चलाओ
Don't follow rule	नियम पालन मत करो
Don't Hide	मत छिपाओ
Don't import	आयात मत करो
Don't mark errors	गलतियों को सूचित मत करो
Don't mirror	दर्पण मत करो
Don't print	छपाई मत करो
Don't replace	प्रतिस्थापित मत करो
Don't separate lines	रेखाओं को मत आलगाना
Don't shift	शिप्ट मत करो
Don't show	मत दिखाओ
Don't split	मत अलगाना
Don't split paragraph	परिच्छेदों को मत अलगाना
Don't split table	सारणी को मत अलगाना
DOS Text	DOS टेक्स्ट्
Dot	बिन्दू
Dot Dash	बिन्दु डॉश
Dot Dash (Bold)	बिन्दु डॉश (मोटा)
Dots	बिन्दु
Dots Bottom	बिन्दु नीचे
Dots to Top	ऊपर केलिए बिन्दु
Dots Vertically	लंबरूप प्रकार से बिन्दु
Dotted	बिन्दी
Dotted (Bold)	बिन्दी (मोटा)
Dotted underline	बिन्दी रेखांकित
Dotted underline (Bold)	बिन्दी रेखांकित (मोटा)
Double	द्विगुणित
Double Arrow	द्विगुणित तीर
Double Arrow Left	द्विगुणित तीर बायाँ
Double Arrow Right	द्विगुणित तीर दाहिना
Double Curve Integral	द्विगुणित पूरा वक्र
Double Dot	द्विगुणित
Double Integral	द्विगुणित पूरा
Double Lines	द्विगुणित रेखाएँ
Double Lines (Scaleable)	द्विगुणित रेखाएँ (स्केल करने योग्य)
Double quotes	द्विगुणित क्वोट्
Double square brackets	द्विगुणित समचतुर्भुज कोष्ठ
Double strikethrough	द्विगुणित स्ट्रैकत्रु
Double Underline	द्विगुणित रेखांकित
Double Wave	द्विगुणित लहर
Double-angled line	द्विगुणित-कोणीय रेखा
down	नीचे
Down	नीचे
Down Arrow	नीचे की तीर
Down One Level	एक सतह नीचे
Download	डौनलोड
Download presentation	प्रस्तुति डौनलोड करो
Downloads	डौनलोड
Downwards	नीचे की ओर
DPRODUCT	DPRODUCT
Drag and Drop	खींचो और गिराओ
Drag Mode	खींचने का प्रकार
Draw	खींचो
Draw Functions	खींचने का फंक्शन्स
Draw object	वस्तु खींचो
Draw Object	वस्तु खींचो
Draw object bar/Graphics	वस्तु पट्टी/सुचित्रों को खींचो
Draw Object text	वस्तु टेक्स्ट् खींचो
draw object(s)	वस्तु खींचो
Draw objects	वस्तुओं को खींचो
Draw text	टेक्स्ट् खींचो
Draw toolbar/Graphics	औजार पट्टी/सुचित्रों को खींचो
Draw Toolbox	औजार बॉक्स खींचो
Drawing	रेखाचित्र
Drawing mode	रेखाचित्र प्रकार
Drawing Object Bar	वस्तु पट्टी रेखाचित्र
Drawing objects	रेखाचित्र वस्तु
Drawing Objects	रेखाचित्र वस्तु
Drawing Options	रेखाचित्र विकल्प
Drawing View	रेखाचित्र दृश्य
Drawing view	रेखाचित्र दृश्य
Drawings	रेखाचित्र
Drawings and controls	रेखाचित्र और नियंत्रण
Drive	ड्रइव
Driver Settings	ड्रइव निर्धारण
Driver settings	ड्रइव निर्धारण
Drop Caps	बड़े अक्षरों को हटाना
Drop Caps over	ऊपर बड़े अक्षरों को हटाना
Dropdown	नीचे गिराओ
Droplets	ड्रॉपलेट्स
DSTDEV	DSTDEV
DSTDEVP	DSTDEVP
DSUM	DSUM
dummy	बनावटी
Duplicate	नकल
Duplicate definition	परिभाषा की नकल
Duplicate section name	विभाग नाम् की नकल
Duplicate Slide	नकली स्लइड
DURATION	DURATION
Duration	अंतराल
Duration of page	पृष्ठ का अंतराल
Duration of pause	रुकावट की अंतराल
Dutch	डच्
Dutch (BEL)	डच् (BEL)
Dutch Guilder	डच् गिल्डर
DVAR	DVAR
DVARP	DVARP
EASTERSUNDAY	EASTERSUNDAY
Ecuador	इक्वडोर
Edit	संपादन
Edit ($Arg1)	संपादन ($Arg1)
Edit 3D View	3D दृश्य का संपादन
Edit All Axes	सब अक्षरेखाओं का संपादन
Edit All Titles	सब शीर्षक का संपादन
Edit Applet	एप्लेट् का संपादन
Edit AutoCorrect	स्वचालित ठीक करनेवाले का संपादन
Edit AutoText	स्वचालित टेक्स्ट् का संपादन
Edit axis	अक्षरेखा का संपादन
Edit bibliography entry	ग्रन्थ-सूची प्रविष्टि का संपादन
Edit Categories	वर्गों का संपादन
Edit Cell Style	कोष्ठ शैली का संपादन
Edit Changes	परिवर्तनों का संपादन
Edit chart area	चार्ट विस्तीर्ण का संपादन
Edit chart data	चार्ट ड़ॉटा का संपादन
Edit chart floor	चार्ट फ्लोर का संपादन
Edit chart type	चार्ट वर्ग का संपादन
Edit chart wall	चार्ट वाल का संपादन
Edit column description	स्तंभ विवरण का संपादन
Edit Comment	अपवाद का संपादन
Edit Concordance File	फाइल का संपादन
Edit Contour	परिवेश का संपादन
Edit Custom Dictionary	कस्टम डैरक्टरी का संपादन
Edit data	ड़ॉटा का संपादन
Edit data point	ड़ॉटा बिन्दु का संपादन
Edit data series	ड़ॉटा श्रृंखला का संपादन
Edit Data Series/Points	ड़ॉटा श्रृंखला/बिन्दु का संपादन
Edit DataPilot Table	ड़ॉटा पैलट् सारणी का संपादन
Edit Field	क्षेत्र का संपादन
Edit Fields	क्षेत्रों का संपादन
Edit File	फाइल का संपादन
Edit Filter Settings	फिल्टर निर्धारण का संपादन
Edit Folder Bookmarks	कोष्ठ पृष्ठ संकेतों का संपादन
Edit Footnote	पृष्ठ के नीचे की टीका का संपादन
Edit Forms	फ़ॉर्मों का संपादन
Edit FrameSet	फ्रेमसेट्ट का संपादन
Edit Function	फंक्शन का संपादन
Edit Glue Points	ग्लू बिन्दुओं का संपादन
Edit graphics	सुचित्रों का संपादन
Edit Graphics	सुचित्रों का संपादन
Edit grid	जाल का संपादन
Edit Group	समूह का संपादन
Edit hyperlink	हाइपरलिंक का संपादन
Edit Index	अनुक्रमणी का संपादन
Edit Index Entry	अनुक्रमणी प्रविष्टि का संपादन
Edit Labels	लेबिलों का संपादन
Edit later	बाद में संपादन करो
Edit legend	लेजन्ड संपादन
Edit links	लिंक्स संपादन
Edit Links	लिंक्स संपादन
Edit Macros	माक्रोस संपादन
Edit MainTitle	मुख्य शीर्षक का संपादन
Edit mask	मास्क का संपादन
Edit negative deviation	निषेधार्थक विचलन का संपादन
Edit Note	टिप्पणी का संपादन
Edit now	अभी संपादन करो
Edit Number Format	संख्या रचना का संपादन
Edit Numbering	संख्या देनेवाले का संपादन
Edit object	वस्तु का संपादन
Edit Page Style	पृष्ठ शैली का संपादन
Edit Paragraph Style	परिच्छेद शैली का संपादन
Edit Points	बिन्दुओं का संपादन
Edit positive deviation	धन विचलन का संपादन
Edit Print Range	छपाई फैलाव का संपादन
Edit Print Ranges	छपाई फैलाव का संपादन
Edit range names	फैलाव नामों का संपादन
Edit scenario	विवरण का संपादन
Edit Script	स्क्रिप्ट् का संपादन
Edit Sections	विभागों का संपादन
Edit Snap Line	स्नाप रेखा का संपादन
Edit Snap Point	स्नाप बिन्दु का संपादन
Edit Style	शैली का संपादन
Edit Subtitle	अधीन शीर्षक का संपादन
Edit Symbols	संकेतों का संपादन
Edit Table	सारणी का संपादन
Edit Template	नमूने का संपादन
Edit title	शीर्षक का संपादन
Edit variable	परिवर्ती संपादन
Edit X Axis	X अक्षरेखा का संपादन
Edit Y Axis	Y अक्षरेखा का संपादन
Edit Z Axis	Z अक्षरेखा का संपादन
Editing time	समय का संपादन
Edition	प्रकाशन
Editor	संपादक
Effect	प्रभाव
effect_rate	प्रभाव_दर
EFFECTIVE	EFFECTIVE
Effects	प्रभाव
Egypt	इजिप्ट्
Eighth Outline Level	आठवाँ बाहरी रूपरेखा सतह
El Salvador	ऐल सल्वडोर
Electronic	ऐलोक्ट्रोनिक
Element	ऐलिमेन्ट्
Element inserted	ऐलिमेन्ट् जोड़ा
Element removed	हटाया हुआ ऐलिमेन्ट्
Element replaced	प्रतिस्थापित ऐलिमेन्ट्
Element resolution	ऐलिमेन्ट् विश्लेषण
Elements	ऐलिमेन्ट्
Eliminate Points	बिन्दुओं को हटाओ
Ellipse	दीर्घवृत्त
Ellipse Frame Tool	दीर्घवृत्त फ्रेम औजार
Ellipse Pie	दीर्घवृत्त पइ
Ellipse Pie, unfilled	दीर्घवृत्त पइ, न भरा हुआ
Ellipse Pies	दीर्घवृत्त पइस
Ellipse Segment	दीर्घवृत्त भाग
Ellipse Segment, unfilled	दीर्घवृत्त भाग, न भरा हुआ
Ellipse Segments	दीर्घवृत्त भाग
Ellipse Tool	दीर्घवृत्त औज़ार
Ellipse, unfilled	दीर्घवृत्त, न भरा हुआ
Ellipses	दीर्घवृत्त
Ellipsoid	दीर्घवृत्तज
Elliptical arc	दीर्घवृत्ताकार चाप
Elliptical arcs	दीर्घवृत्ताकार चाप
Else	Else
Else/Endif without If	If रहित Else/Endif
E-mail	E-mail
e-mail	इ-मेइल
E-mail address	E-mail पता
E-mail News	E-mail समाचार
embedded object (OLE)	सम्मिलित वस्तु (OLE)
Embedded objects (OLE)	सम्मिलित वस्तु (OLE)
Emphasis	ऐम्फसिस
empty	खाली
Empty	खाली
Empty presentation	प्रस्तुति को खाली करो
Empty Recycle Bin	रिसैकल बिन को खाली करो
Empty Set	खाली समूह
Enable	सक्षम
Enable Key	सक्षम की
Enable key	सक्षम की
Enable plug-ins	प्लग-ईन को सक्षम करो
Enable security checks	रक्षा जाँच को सक्षम करो
Enable Watch	परीक्षण को सक्षम करो
Enabled	सक्षम किया
Enclosed Alphanumerics	घिरा हुआ आल्फा न्यूमरिक
Enclosure(s)	घेरा
Encode (PGP)	ऐनकोड (PGP)
Encoding Type	ऐनकोड करने का वर्ग
End	अन्त
End angle	अंतिम कोण
End horizontal	समतल अंत
End of document	लेखपत्र की अंत
End of footnote	पृष्ठ के नीचे की टीका की अंत
End of page	पृष्ठ की अंत
End quote	अंतिम क्वोट्
End Task	कार्य को अंत करो
End value	अंतिम मूल्य
End vertical	लंबरूप अंत
Endless	अनन्त
Endnote	अंत की टीका
Endnote anchor	अंत की टीका जोड़
Endnote area	अंत की टीका की विस्तीर्ण
Endnote Characters	अंत की टीका की अक्षरें
Endnotes	अंत की टीका
English	अंग्रेजी
english	अंग्रेजी
English (AUS)	अंग्रेजी (AUS)
English (Belize)	अंग्रेजी (बिलैज़)
English (CAN)	अंग्रेजी (CAN)
English (Caribbean)	अंग्रेजी (केरिबियन)
English (Eire)	अंग्रेजी (अइरे)
English (Jamaica)	अंग्रेजी (जमैका)
English (NZ)	अंग्रेजी (NZ)
English (Philippines)	अंग्रेजी (पिलिपैन्स)
English (SA)	अंग्रेजी (SA)
English (Trinidad)	अंग्रेजी (ट्रिनिडाड)
English (UK)	अंग्रेजी (UK)
English (US)	अंग्रेजी (US)
English (Zimbabwe)	अंग्रेजी (झिम्बावे)
English US	अंग्रेजी US
Enhance edges	किनारों को बढ़ाना
Enlargement	बढ़ती
Enter Group	समूह प्रविष्ट करो
Enter Password	कूटशब्द प्रविष्ट करो
Enter References	रेफरेन्स प्रविष्ट करो
Enter sender address	भेजनेवाले का पता को प्रविष्ट करो
Enter SQL statement	SQL वाक्य को प्रविष्ट करो
Enter title	शीर्षक प्रविष्ट करो
Enter URL	URL प्रविष्ट करो
Enter User Data	उपभोक्ता का ड़ॉटा को प्रविष्ट करो
Entire cells	सम्पूर्ण कोष्ठ
Entire column	सम्पूर्ण स्तंभ
Entire document	सम्पूर्ण लेखपत्र
Entire Formula	सम्पूर्ण सूत्र
Entire frame	सम्पूर्ण फ्रेम
Entire Page	सम्पूर्ण पृष्ठ
Entire page	सम्पूर्ण पृष्ठ
Entire row	सम्पूर्ण पंक्ति
Entries	प्रविष्टि
Entry	प्रविष्टि
Entry data	प्रविष्टि ड़ॉटा
Entry required	प्रविष्टि की आवश्यकता
Entry text	प्रविष्टि टेक्स्ट्
Envelope	लिफाफा
Envelope Settings	लिफाफा निर्धारण
EPS color format	EPS रंग की रचना
EPS compression mode	EPS दबाव प्रकार
EPS Export Options	EPS निर्यात विकल्प
EPS preview image	EPS पूर्वदृश्य चित्र
EPS version	EPS आवर्तन
equal	समान
Equal	समान
equal to	के समान
Err	गलती
Error	गलती
ERROR :	ERROR :
Error Alert	गलती सावधान
Error categories	गलती वर्ग
Error category	गलती वर्ग
Error code	गलती कोड
Error creating object	वस्तु को उत्पन्न करने के समय गलती
Error deleting data.	ड़ॉटा को मिटाने के समय गलती
error indicator	गलती निदर्शक
Error indicator	गलती निदर्शक
Error initializing object-system.	वस्तु-सिस्टम को इनिश्यलैज़ करने के समय गलती घटित हुआ ।
Error list	गलती सूची
Error loading converter	कनवर्टर को लोड करने के समय गलती
Error loading library	लैब्ररी लोड करने के समय गलती
Error margin	पृष्ठ-प्रान्त में गलती
Error message	गलती की सन्देश
Error occurred	गलती घटित हुआ
Error opening file	फाइल को खोलने के समय गलती
Error removing library	लैब्ररी हटाने के समय गलती
Error resolving name	नाम निश्चय करने के समय गलती
Error sending mail.	मेइल भेजने के समय गलती
Error while printing	छपाई करने के समय गलती
Error while renaming	नया नाम् देने के समय गलती
Error: Circular reference	गलती: चक्राकार रेफरेन्स
Error: Formula overflow	गलती: सूत्र अधिकता
Error: in bracketing	गलती: कोष्ठक ढालने में
Error: Internal overflow	गलती: भीतरी अधिकता
Error: Invalid argument	गलती: अमान्य आर्गुमेन्ट्
Error: Invalid character	गलती: अमान्य अक्षर
Error: Invalid name	गलती: अमान्य नाम
Error: Invalid semicolon	गलती: अमान्य अर्ध विराम का चिह्न
Error: No result	गलती: नतीजा नहीं
Error: Operator missing	गलती: अनुपस्थित प्रवर्तक
Error: String overflow	गलती: अक्षर समुह अधिकता
Error: Variable missing	गलती: अनुपस्थित परिवर्ती
ERRORTYPE	ERRORTYPE
Estonia	इस्टोनिया
Estonian	इस्टोनियन
Ethiopic	इथियोपिक
Euro Converter	यूरो में बदलनेवाला
Europe	यूरोप
Evaluation level	परीक्षा करने की सतह
Evaluation Minutes	परीक्षा करने की मिनट
EVEN	EVEN
Event	घटना
Events	घटना
Every	प्रत्येक
Exact	यथार्थ
EXACT	EXACT
Example	उदाहरण
Excel Documents	ऐक्सेल लेखपत्र
Excel templates	ऐक्सेल नमूनें
Exception (-)	अपवाद (-)
Exceptions	अपवाद
Excess length	अधिक विस्तार
Excess size	अधिक परिमाण
Excess size (left/right)	अधिक परिमाण (बायाँ/दाहिना)
Exchange background page	पृष्ठभाग पृष्ठ को अदला-बदला करो
Exchange characters	अक्षरों को अदला-बदला करो
Exchange Database	लेखासंचय को अदला-बदला करो
Exchange databases	लेखासंचयों को अदला-बदला करो
Exchange source	मूल को अदला-बदला करो
Exclusive access	निषेधक प्रवेश
Execute	चलाओ
Execute in	में चलाओ
Execute Macro	मॉक्रो चलाओ
Execute macro	मॉक्रो चलाओ
Execute program	प्रोग्राम चलाओ
Execute query immediately	जानकारी को तुरन्त चलाओ
Execute SQL Statement	SQL वाक्य चलाओ
Existing columns	अस्तित्व में रहनेवाला स्तंभ
Existing Design	अस्तित्व में रहनेवाला डिसैन
Existing Fields	अस्तित्व में रहनेवाला क्षेत्रें
Existing fields	अस्तित्व में रहनेवाला क्षेत्रें
Existing slides	अस्तित्व में रहनेवाला स्लइडस
Existing versions	अस्तित्व में रहनेवाला आवर्तन
Exit	निर्गम करो
Exit All Groups	सब समूह से निर्गम करो
Exit Direction	निर्गम करने की दिशा
Exit direction	निर्गम करने की दिशा
Exit Direction Bottom	नीच की ओर से निर्गम करो
Exit Direction Left	बायाँ ओर से निर्गम करो
Exit Direction Right	दाहिनी ओर से निर्गम करो
Exit Direction Top	ऊपर की दिशा से निर्गम करो
Exit Fill Mode	भरने का प्रकार से निर्गम करो
Exit Group	समूह से निर्गम करो
Exit group	समूह से निर्गम करो
Exit Position	स्थान से निर्गम करो
Exit Presentation	प्रस्तुति से निर्गम करो
Exit presentation	प्रस्तुति से निर्गम करो
Exit Recording	रेकोर्डिन्ग से निर्गम करो
Expand formatting	रचना को विस्तार करो
Expand single word	अकेला शब्द को विस्तार करो
Expand Slide	स्लइड को विस्तार करना
Expanded	विस्तृत
Experts	निपुण
Expires	समाप्त होना
EXPONDIST	EXPONDIST
Exponential Function	ऐक्स्पोनेश्यल फ़ंक्शन
Exponential increasing	ऐक्स्पोनेश्यल प्रकार से बढना
Exponential Regression	ऐक्स्पोनेश्यल रिग्रेश्यन
Export	निर्यात करो
Export settings	निर्धारण को निर्यात करो
Export source	मूल को निर्यात करो
Export Template	नमूने को निर्यात करो
Export vCard	विकार्ड निर्यात करो
Exporting	निर्यात करना
Exporting document	लेखपत्र को निर्यात करना
Exporting to %1	%1 केलिए निर्यात करना
Expression	वर्णन
Expression too complex	बहुत जटिल वर्णन
EXT	EXT
Ext. attribute	विस्तृत ऐट्रिब्यूट्
Extend edges	किनारों को विस्तार करना
Extended	विस्तृत
Extended Help	विस्तृत सहायता
Extended Selection On	विस्तृत चुनाव शुरु
Extended Tips	विस्तृत सुझावें
Extension	विस्तार
Extent	विस्तार
External	बाहरी
External application busy	बाहरी कार्यक्रम कार्य निरत
External browser	बाहरी ब्रउज़र
External Browser	बाहरी ब्रउज़र
External Language	बाहरी भाषा
External Source	बाहरी मूल
External source/interface	बाहरी मूल/इन्टरफेस
Extras	अतिरिक्त
Extrusion object	निष्कासन वस्तु
Extrusion objects	निष्कासन वस्तु
Eyedropper	अइड्रापर
FACT	FACT
factor	भाज्य
Factorial	क्रमगुणित
Fade	फीका पडना
Fade Clockwise	बायाँ ओर से दाहिनी ओर तक फीका करना
Fade Counter-Clockwise	दाहिनी ओर से बायाँ ओर तक फीका करना
Fade from Center	मध्य भाग से फीका करना
Fade Horizontally	समतल प्रकार से फीका करना
Fade object	वस्तु को फीका करना
Fade out	फीका करना
Fade to Center	मध्य भाग में फीका करना
Fade Vertically	लंबरूप प्रकार से फीका करना
Faeroese	फएरोसी
Faroe Islands	फरोइ अइलान्ड
Farsi	फ़ार्सी
Fast	तेज
Faulty database configuration	दोषयुक्त लेखासंचय रूपरेखा
Faulty password confirmation	दोषयुक्त कूटशब्द प्रमाणीकरण
Favorite	प्रिय
Favorites	प्रिय
Fax	फ़ॉक्स
Fax / E-mail	फ़ॉक्स / E-mail
Fax Cover	फ़ॉक्स
Fax Letter	फ़ॉक्स पत्र
Fax Message	फ़ॉक्स सन्देश
Fax Note	फ़ॉक्स टीका
Fax number	फ़ॉक्स संख्या
Fax recipient data	फ़ॉक्स प्रतिग्राहक ड़ॉटा
FDIST	FDIST
Feb	फरवरी
February	फरवरी
Field	क्षेत्र
Field codes	क्षेत्र कोड
Field delimiter	क्षेत्र परिसीमित करनेवाला
Field Format	क्षेत्र रचना
Field length	क्षेत्र विस्तार
Field name	क्षेत्र नाम्
Field Names On/Off	क्षेत्र नाम् शुरु/बंद
Field options	क्षेत्र विकल्प
Field properties	क्षेत्र विशेषतायें
Field selection	क्षेत्र चुनाव
Field separator	क्षेत्र अलगानेवाला
Field Shadings	क्षेत्र छाया
Field type	क्षेत्र वर्ग
Fields	क्षेत्र
Fields and charts	क्षेत्र और चार्ट
Fields in Form	फ़ॉर्म की क्षेत्र
Fields in Query	जानकारी की क्षेत्र
fields involved	क्षेत्र सम्बद्ध
Fiery	तीक्ष्ण
Fifth Outline Level	पाँचवाँ बाहरी रूपरेखा सतह
File	फाइल
FILE	FILE
File / URL	फाइल / URL
File already exists	फाइल पहिले से ही अस्तित्व में है
File already open	फाइल पहिले से ही खुला है
File Document	फाइल लेखपत्र
File format	फाइल रचना
File List	फाइल सूची
File name	फाइल का नाम
File Name	फाइल का नाम
File not found	फाइल नहीं मिला
File Properties	फाइल का विशेषतायें
File Recovery	फाइल पुनः प्राप्ति
File Selection	फाइल चुनाव
File size	फाइल परिमाण
File system	फाइल सिस्टम
File System	फाइल सिस्टम
File to convert	फाइल बदलने केलिए
File type	फाइल वर्ग
File Type	फाइल वर्ग
File Types	फाइल वर्ग
File types	फाइल वर्ग
File.win	File.win
Filemaker	फाइल बनानेवाला
Files	फाइलें
Fill	भरो
Fill character	अक्षर भरो
Fill Color	रंग भरो
Fill color	रंग भरो
Fill Data Series	ड़ॉटा श्रृंखला भरो
Fill Down	नीचे की ओर भरो
Fill entire page	सम्पूर्ण पृष्ठ भरो
Fill Format Mode	रचना प्रकार भरो
Fill holes	छेदों को भरो
Fill Left	बायाँ ओर भरो
Fill Mode	भरने का प्रकार
Fill parameters	पैरामीटर भरो
Fill Right	दाहिनी ओर भरो
Fill Row	पंक्ति भरो
Fill Series	श्रृंखला भरो
Fill Sheet	शीट् भरो
Fill Sheets	शीटों को भरो
Fill Up	ऊपर की ओर भरो
Fillbitmap	भरने का बिटमॉप्
Fillbitmap position	भरने का बिटमॉप् की स्थान
Fillbitmap width	भरने का बिटमॉप् की चौड़ाई
Fillcolor	भरने का रंग
Fillstyle	भरने का शैली
Filter	फिल्टर
Filter bar	फिल्टर पट्टी
Filter for	केलिए फिल्टर
Filter navigation	फिल्टर नाविगेशन
Filter navigator	फिल्टर नाविगेटर
Filter not found.	फिल्टर नहीं मिला ।
Filter options	फिल्टर विकल्प
Filter proposal	फिल्टर प्रस्ताव
Filter Settings	फिल्टर निर्धारण
Filtering	फिल्टर करना
Filters	फिल्टरें
Final angle	अंतिम कोण
Financial	वित्तसम्बन्धी
Find	अन्वेषण करो
FIND	FIND
Find Address	पता अन्वेषण करो
Find All	सब अन्वेषण करो
Find files	फाइलों को अन्वेषण करो
Find graphics	सुचित्रों को अन्वेषण करो
Find on Page	पृष्ठ में अन्वेषण करो
Find On/Off	अन्वेषण करना शुरु/बंद
Find Original	यथार्थ को अन्वेषण करो
Find parentheses	कोष्ठक को अन्वेषण करो
Find Parenthesis	कोष्ठक को अन्वेषण करो
Find Record	अभिलेख को अन्वेषण करो
Find Replace	अन्वेषण प्रतिस्थापित करो
find_text	अन्वेषण_टेक्स्ट्
Fine dashed	सूक्ष्म प्रकार से डाश की हुयी
Fine dashed (variable)	सूक्ष्म प्रकार से डाश की हुयी (परिवर्तनीय)
Fine dotted	सूक्ष्म प्रकार से बिन्दी
Finish	समाप्त
Finland	फिनलान्ड
Finnish	फिन्निश
Finnish Mark	फिन्निश चिह्न
FINV	FINV
Firing	फयरिंग
First Level	पहिला सतह
First Line	पहिला रेखा
First line	पहिला रेखा
First line indent	पहिला रेखा इन्डेन्ट
First Name	पहिला नाम
First name	पहिला नाम
First Page	पहिला पृष्ठ
First page	पहिला पृष्ठ
First page number	पहिला पृष्ठ संख्या
First paragraph	पहिला परिच्छेद
First Paragraph	पहिला परिच्छेद
First Record	पहिला अभिलेख
First/Last name/Initials	पहिला/अंतिम नाम/इनिश्यल
FISHERINV	FISHERINV
Fit to Frame	फ़्रेम केलिए योग्य
Fit to frame	फ़्रेम केलिए योग्य
Fit to size	परिमाण केलिए योग्य
Fit to Window	विन्डों केलिए योग्य
Fit-to-size text object	परिमाण के योग्य टेक्स्ट् वस्तु
Fit-to-size text objects	परिमाण के योग्य टेक्स्ट् वस्तु
Fixed	स्थिर
FIXED	FIXED
Fixed content	स्थिर विषय
Fixed height	स्थिर ऊँचाई
Fixed Horizontal Center	स्थिर समतल मध्यभाग
Fixed Horizontal Left	स्थिर समतल बायाँ
Fixed Horizontal Right	स्थिर समतल दाहिना
Fixed legend angle	स्थिर लेजन्ड कोण
Fixed Position	स्थिर स्थान
Fixed Vertical Bottom	स्थिर लंबरूप नीचे
Fixed Vertical Center	स्थिर लंबरूप मध्यभाग
Fixed Vertical Top	स्थिर लंबरूप ऊपर
Fixed width	स्थिर चौड़ाई
Fixed, proportional	स्थिर, अनुरूप
Flags	पताका
flash	चमक
Flat	समतल
Flat buttons	समतल बटन
Flip	प्लिप करो
Flip horizontal	समतल में प्लिप करो
Flip horizontally	समतल प्रकार से प्लिप
Flip Object Horizontally	वस्तु को समतल प्रकार से प्लिप करो
Flip vertical	लंबरूप में प्लिप करो
Flip Vertically	लंबरूप प्रकार से प्लिप
Flip vertically	लंबरूप प्रकार से प्लिप
Floating Frame	फ्लोटिंग फ्रेम
Floating Frame Properties	फ्लोटिंग फ्रेम विशेषतायें
Floating Task	फ्लोटिंग कार्य
FLOOR	FLOOR
Flow charts	फ्लोचार्ट
Focal length	ताल के मध्य से उसके केन्द्र तक की दूरी
Focus gained	फोकस प्राप्त करना
Focus lost	फोकस नष्ट होना
Folder	कोष्ठ
Folder Bookmarks	पृष्ठ संकेत कोष्ठ
Following page	अगला पृष्ठ
Follow-up	सहायता करना
Followup To	को सहायता करना
Follow-up To	को सहायता करना
Font	फ़ॉन्ट
Font "StarBats"	फ़ॉन्ट "StarBats"
Font "StarMath"	फ़ॉन्ट "StarMath"
Font Attributes	फ़ॉन्ट ऐट्रिब्यूट्स
Font Color	फ़ॉन्ट की रंग
Font Color Fill	फ़ॉन्ट की रंग भरो
Font Effects	फ़ॉन्ट प्रभाव
Font Height	फ़ॉन्ट ऊँचाई
Font history	फ़ॉन्ट हिस्टरी
Font Name	फ़ॉन्ट नाम
Font Posture	फ़ॉन्ट स्थिति
Font Replacement	फ़ॉन्ट प्रतिस्थापन
Font shadow	फ़ॉन्ट छाया
Font size	फ़ॉन्ट परिमाण
Font Size	फ़ॉन्ट परिमाण
Font sizes	फ़ॉन्ट परिमाण
Font Types	फ़ॉन्ट वर्ग
Font Weight	फ़ॉन्ट दबाव
Font width	फ़ॉन्ट चौड़ाई
Fonts	फ़ॉन्ट
FontWork	फ़ॉन्टवर्क
Fontwork alignment	फ़ॉन्टवर्क पंक्तिकरण
Fontwork attributes	फ़ॉन्टवर्क ऐट्रिब्यूट्स
Fontwork default form	फ़ॉन्टवर्क अनुपस्थिति फ़ॉर्म
Fontwork font begin	फ़ॉन्टवर्क फ़ॉन्ट प्रारंभ
Fontwork mirror	फ़ॉन्टवर्क दर्पण
Fontwork outline	फ़ॉन्टवर्क बाहरी रूपरेखा
Fontwork shadow	फ़ॉन्टवर्क छाया
Fontwork shadow color	फ़ॉन्टवर्क छाया की रंग
FontWork shadow transparency	फ़ॉन्टवर्क छाया की पारदर्शकता
FontWork spacing	फ़ॉन्टवर्क में अंतर देना
Fontwork style	फ़ॉन्टवर्क शैली
Foot	अधोभाग
Footer	पृष्ठ के अधोभाग की टीका
Footer (left)	पृष्ठ के अधोभाग की टीका (बायाँ)
Footer (right)	पृष्ठ के अधोभाग की टीका (दाहिना)
Footer left	पृष्ठ के अधोभाग की टीका बायाँ
Footer on	पृष्ठ के अधोभाग की टीका शुरु
Footer right	पृष्ठ के अधोभाग की टीका दाहिना
Footers	पृष्ठ के अधोभाग की टीका
Footnote	पृष्ठ के नीचे की टीका
Footnote anchor	पृष्ठ के नीचे की टीका की जोड़
Footnote area	पृष्ठ के नीचे की टीका की विस्तीर्ण
Footnote Characters	पृष्ठ के नीचे की टीका की अक्षरें
Footnote Settings	पृष्ठ के नीचे की टीका की निर्धारण
Footnotes	पृष्ठ के नीचे की टीका
Footnotes/Endnotes	पृष्ठ के नीचे की टीका/अंतिम टीका
For	केलिए
For All	सब केलिए
For data range	ड़ॉटा फैलाव केलिए
For your information	आपकी जानकारी केलिए
FORECAST	FORECAST
Foreground	दर्शक के अति समीप भाग
Foreground Color	दर्शक के अति समीप भाग की रंग
Foreground Trasparence	दर्शक के अति समीप भाग पारदर्शक
Form	फ़ॉर्म
Form Controls	फ़ॉर्म नियंत्रण
Form design	फ़ॉर्म डिसैन
Form Functions	फ़ॉर्म फ़ंक्शन
Form letter	फ़ॉर्म पत्र
Form Letter	फ़ॉर्म पत्र
Form letter field	फ़ॉर्म पत्र की क्षेत्र
Form Name	फ़ॉर्म का नाम्
Form name	फ़ॉर्म का नाम्
Form Navigator	फ़ॉर्म नाविगेटर
Form objects	फ़ॉर्म वस्तु
Form of addr/Title	पता/शीर्षक की फ़ॉर्म
Form properties	फ़ॉर्म विशेषतायें
Form_	फ़ॉर्म_
Format	रचना
Format cell	रचना कोष्ठ
Format Cell	रचना कोष्ठ
Format Cells	रचना कोष्ठ
Format code	रचना कोड
Format Example	रचना उदाहरण
Format Menu	रचना मेनु
Format: Paragraph	रचना: परिच्छेद
Formats	रचना
Formats for Cells	कोष्ठों केलिए रचना
Formatted	रचना की हुयी
Formatted Field	रचना की हुयी क्षेत्र
Formatted text (RTF)	रचना की हुयी टेक्स्ट् (RTF)
Formatting	रचना करना
Formatting document automatically	स्वचालित प्रकार से लेखपत्र को रचना करना
Formatting On/Off	रचना करना शुरु/बंद
Form-based filters	फ़ॉर्म-आधारित फिल्टरें
Forms	फ़ॉर्म
Formula	सूत्र
FORMULA	FORMULA
Formula	सूत्र
Formula Bar	सूत्र पट्टी
Formula Bar On/Off	सूत्र पट्टी शुरु/बंद
Formula cell	सूत्र कोष्ठ
Formula Cursor	सूत्र कर्सर
Formula fonts	सूत्र फ़ॉन्ट
Formula is	सूत्र
Formula Options	सूत्र विकल्प
Formula Options: Settings	सूत्र विकल्प: निर्धारण
Formula text	सूत्र टेक्स्ट्
Formulas	सूत्र
Forward	आगे की ओर
Forward Message	सन्देश आगे की ओर
Forward One	आगे की ओर का
Four Slides	चार स्लइडस
Fourth Outline Level	चौथा बाहरी रूपरेखा सतह
Fr	एफ आर
Fraction	फ्रॉक्शन
Fraction bar	फ्रॉक्शन पट्टी
Fraction Bars	फ्रॉक्शन पट्टी
Fractions	फ्रॉक्शन
Frame	फ्रेम
Frame contents	फ्रेम विषय
Frame Control	फ्रेम नियंत्रण
Frame element	फ्रेम ऐलिमेन्ट्
Frame Object Bar	फ्रेम वस्तु पट्टी
Frame Object Bar/Web	फ्रेम वस्तु पट्टी/वेब
Frame only	केवल फ्रेम
Frame Properties	फ्रेम विशेषतायें
Frame Size	फ्रेम परिमाण
Frame Spacing	फ्रेम का अंतर देना
Frame Style	फ्रेम शैली
Frame Styles	फ्रेम शैलियाँ
Frame text area	फ्रेम टेक्स्ट् विस्तीर्ण
Frame/Web	फ्रेम/वेब
Frames	फ्रेम
FrameSet	फ्रेमसेट्ट
FrameSet Document	फ्रेमसेट्ट लेखपत्र
FrameSet Spacing	फ्रेमसेट्ट का अंतर देना
France	फ्रान्स
Free	मुक्त
Free indexes	मुक्त अनुक्रमणी
Free positioning	मुक्त स्थान देना
Free rotation	मुक्त घुमाव
Free Rotation	मुक्त घुमाव
Free Rotation Angle	मुक्त घुमाव कोण
Free space (MB)	मुक्त जगह (MB)
Freeform	मुक्त रचना
Freeform Curve	मुक्त रचित वक्र
Freeform Line	मुक्त रचित रेखा
Freeform Lines	मुक्त रचित रेखाएँ
Freeform Polygon	मुक्त रचित बहुभुज
Freeze	फ्रीज़
Freeze Window	विन्डो फ्रीज़ करो
French	फ्रेन्च
French (BEL)	फ्रेन्च (BEL)
French (CAN)	फ्रेन्च (CAN)
French (CH)	फ्रेन्च (CH)
French (LUX)	फ्रेन्च (LUX)
French (Monaco)	फ्रेन्च (मोनोको)
French Franc	फ्रेन्च फ्रान्क
Frequency	तीव्रता
FREQUENCY	FREQUENCY
From	से
From Beginning	प्रारंभ से
From bibliography database	ग्रन्थ-सूची लेखासंचय से
From bottom	नीचे से
From database	लेखासंचय से
From document content	लेखपत्र विषय से
From File	फाइल से
From file	फाइल से
From Image Editor	चित्र संपादक से
From inside	भीतरी ओर से
From left	बायाँ ओर से
from left	बायाँ ओर से
From list	सूची से
From printer settings	मुद्रक निर्धारण से
From right	दाहिनी ओर से
From row	पंक्ति से
From system settings	सिस्टम निर्धारण से
From Template	नमूने से
From template	नमूने से
From text	टेक्स्ट् से
From top	ऊपर से
from top	ऊपर से
Front side	सामने का भाग
FTEST	FTEST
FTP	FTP
FTP Account	FTP हिसाब
FTP File	FTP फाइल
FTP Folder	FTP कोष्ठ
FTP Link	FTP कड़ी
Ftp Proxy	FTP प्रॉक्सी
Full (Outer) Join	सम्पूर्ण (बाहरी) जोड़
full circle	सम्पूर्ण वृत्त
Full Screen	सम्पूर्ण परदा
Full width	सम्पूर्ण चौड़ाई
Function	फंक्शन्
Function Bar	फंक्शन् डन्डा
Function Bar On/Off	फंक्शन् पट्टी शुरु/बंद
Function expected	फंक्शन् की प्रतीक्षा
Function List	फंक्शन् सूची
Function not known	अज्ञात फंक्शन्
Function result	फंक्शन् की नतीजा
Function sequence error	फंक्शन् श्रेणी गलती
Function_type	फंक्शन_वर्ग
functions	फंक्शन्
Functions	फंक्शन्
Functions for Cells	कोष्ठों केलिए फंक्शन्स
Functions List	फंक्शन् सूची
FunMore	अधिक फंक्शन्
Furniture	चल सामाग्री
Further information	अधिकतर सूचना
Further objects	अधिकतर वस्तु
Further OLE objects	अधिकतर OLE वस्तु
Further settings	अधिकतर निर्धारण
Gallery	गेलरी
Gallery theme	गेलरी विषय
Gallery Theme	गेलरी विषय
Gamma	गामा
Gamma Correction	गामा सुधार
Gamma value	गामा मूल्य
Gamma	गामा
GAMMADIST	GAMMADIST
GAMMAINV	GAMMAINV
GAMMALN	GAMMALN
Gap	अंतर
GB	GB
GCD	GCD
General	सामान्य
General error	सामान्य गलती
General Error	सामान्य गलती
General handling	सामान्य व्यवहार
General Help Modules	सामान्य सहायता मोड्यूल
General input/output error	सामान्य इनपुट्/औटपुट् गलती
General network error	सामान्य
General OLE Error	सामान्य OLE गलती
General Options	सामान्य विकल्प
General Punctuation	सामान्य विराम चिह्न
General warning	सामान्य चेतावनी
Generating source	मूल उत्पन्न करना
Generic	साधारण
GEOMEAN	GEOMEAN
Geometric Shapes	रेखागणित-सम्बन्धी आकार
Geometry	रेखागणित
Georgia	जोर्जिया
Georgian Extended	जोर्जियन विस्तृत
German	जर्मन
German (A)	जर्मन (A)
German (CH)	जर्मन (CH)
German (LIE)	जर्मन (LIE)
German (LUX)	जर्मन (LUX)
German Mark	जर्मन चिह्न
German spelling	जर्मन शब्द-विन्यास
Germany	जर्मनी
Get	प्राप्त करना
GIF Options	GIF विकल्प
Given angle	दिया हुआ कोण
Global settings	ग्लोबल निर्धारण
Glue Point Relative	ग्लू बिन्दु सम्बन्धित
Glue Points Mode	ग्लू बिन्दु प्रकार
Go Right	दाहिनी ओर जाओ
Go to document	लेखपत्र में जाओ
Go to Homepage	मुख्य पृष्ठ में जाओ
go to record	अभिलेख में जाओ
Goal Seek	लक्ष खोजना
GOALSEEK	GOALSEEK
Gold	सोना
Gouraud	गौरौड
GPF occured	GPF घटित हुआ
Gradient	ग्रेडिऐन्ट्
Gradients	ग्रेडिऐन्ट्स
Grand Total	कुल जोड़
Graphic	सुचित्र
Graphics	सुचित्र
Graphics and objects	सुचित्र और वस्तु
Graphics attributes	सुचित्रों का ऐट्रिब्यूट्स
Graphics directory	सुचित्रों का डैरक्टरी
Graphics Export	सुचित्रों का निर्यात
Graphics file name	सुचित्र फाइल का नाम
Graphics filter	सुचित्र फिल्टर
Graphics load faulty	सुचित्र लोड में गलती
Graphics load successful	सुचित्र लोड में सफलता
Graphics load terminated	सुचित्र लोड समाप्त हुआ
Graphics mode	सुचित्र प्रकार
Graphics Object Bar	सुचित्र वस्तु पट्टी
Graphics Object Bar/Web	सुचित्र वस्तु पट्टी/वेब
Graphics objects	सुचित्र वस्तु
Graphics Off	सुचित्र बंद
Graphics on/off	सुचित्र शुरु/बंद
Graphics Properties	सुचित्र विशेषतायें
Graphics Styles	सुचित्र शैलियाँ
Gravel	ग्रेवल
Gray	ग्रे
Grayscale	ग्रेस्केल
Grayscale Preview	ग्रेस्केल पूर्वदृश्य
Greater	अधिक
greater or equal	अधिक अथवा समान
greater than	से अधिक
Greatest Common Divisor	अधिकतम सामान्य भाजक
Greece	ग्रीस
Greek	ग्रीक
Greek Extended	विस्तृत ग्रीक
Green	हरा
Grenada	ग्रेनडा
Grid	जाल
Grid color	जाल की रंग
Grid Lines	जाल रेखाएँ
Grid lines	जाल रेखाएँ
Grid to Front	सामने की ओर जाल
Group	समूह
Group Box	समूह बॉक्स
Group Brackets	समूह कोष्ठक
Group by	समूह में
Group draw objects	खींचने का वस्तुओं के समूह
group object	वस्तु समूह
Group object	वस्तु समूह
group objects	वस्तुओं के समूह
Group View	समूह दृश्य
Grouping not possible	एकत्रित करना असंभव
Groups	समूह
GROWTH	GROWTH
Growth	विकास
Guadeloupe	गुवाडेलोप
Guatemala	गुवाटेमाला
guess	अनुमान करो
Guests	अतिथि
Guide distance	सलाह का दूरी
Guide overhang	सलाह का ओवरहान्ग
Guides	सलाह
Guides to Front	सामने की ओर सलाह
Guides When Moving	स्थान परिवर्तन के समय सलाह देना
Guides when moving	स्थान परिवर्तन के समय सलाह देना
Gujarati	गुजराति
Gurmukhi	गुर्मुखि
Guyana	गयाना
h Bar	h पट्टी
H. Pitch	H. पिच
Haiti	हाइटि
Half-Sphere	आधा-गोल
Handout	हान्डौट्
Handout Background	हान्डौट् पृष्ठभाग
Handout View	हान्डौट् दृश्य
Handout view	हान्डौट् दृश्य
Handouts	हान्डौट्स
Hanging indent	हांगिंग इन्डेन्ट
Hangul	हानगल
Hangul Ah	हानगल आ
Hangul Ba	हानगल ब
Hangul Cha	हानगल छ
Hangul Compatibility Jamo	हानगल योग्य जामो
Hangul Da	हानगल ड
Hangul Ga	हानगल ग
Hangul Ha	हानगल ह
Hangul Ja	हानगल ज
Hangul Jamo	हानगल जामो
Hangul Ka	हानगल क
Hangul Ma	हानगल म
Hangul Na	हानगल न
Hangul Pa	हानगल प
Hangul Ra	हानगल र
Hangul Sa	हानगल स
Hangul Ta	हानगल ट
Hard disk cache	हार्ड डिस्क कॉश
HARMEAN	HARMEAN
Hatching	हाचिंग
Hatching background	हाचिंग पृष्ठभाग
Header	शीर्षक
Header (left)	पृष्ठ के ऊपर की टीका (बायाँ)
Header (right)	पृष्ठ के ऊपर की टीका (दाहिना)
Header left	पृष्ठ के ऊपर की टीका बायाँ
Header on	पृष्ठ के ऊपर की टीका शुरु
Header right	पृष्ठ के ऊपर की टीका दाहिना
Header settings	पृष्ठ के ऊपर की टीका की निर्धारण
Headers	पृष्ठ के ऊपर की टीका
Headers and Footers	पृष्ठ के ऊपर और नीचे की टीका
Headers Footers	पृष्ठ के ऊपर और नीचे की टीका
Headers/Footers	पृष्ठ के ऊपर की टीका/पृष्ठ के नीचे की टीका
Heading	शीर्षक
Heading Levels Shown	शीर्षक स्तरों को दिखाया है
Heading2	शीर्षक2
Hebrew	हिब्रू
Hebrew Extended	हिब्रू विस्तृत
Height	ऊँचाई
Height of fillbitmap	फिलबिटमॉप् की  ऊँचाई
Height, complete	ऊँचाई, समाप्ती
Help	सहायता
Help about Help	सहायता के बारे में सहायता
Help Agent	सहायता कार्यकर्ता
Help Bar	सहायता पट्टी
Help file	सहायता फाइल
Help file name	सहायता फाइल का नाम
Help ID	सहायता ID
Help index	सहायता अनुक्रमणी
Help information	सहायता सूचना
Help Menu	सहायता मेनु
Help on Help	सहायता केलिए सहायता
Help text	सहायता टेक्स्ट्
Help URL	सहायता URL
HID directory	HID डैरक्टरी
Hidden	छिपा हुआ
hidden	छिपा हुआ
Hidden Control	छिपा हुआ नियंत्रण
Hidden Objects	छिपा हुआ वस्तु
Hidden pages	छिपा हुआ पृष्ठ
Hidden Paragraph	छिपा हुआ परिच्छेद
Hidden paragraphs	छिपा हुआ परिच्छेद
Hidden Paragraphs	छिपा हुआ परिच्छेद
Hidden Sheets	छिपा हुआ शीट्
Hidden text	छिपा हुआ टेक्सट्
Hide	छिपाना
Hide all	सब छिपाना
Hide Author	लेखक को छिपाना
Hide AutoFilter	स्वचालित फिल्टर छिपाना
Hide Column	स्तंभ को छिपाओ
Hide Columns	स्तंभों को छिपाओ
Hide Details	विवरणों को छिपाओ
Hide details	विवरणों को छिपाना
Hide Errors	गलतियों को छिपाना
Hide Field	क्षेत्र को छिपाना
Hide fontwork outline	फ़ॉन्टवर्क की बाहरी रूपरेखा को छिपाना
Hide formula	सूत्र को छिपाना
Hide note	टिप्पणी छिपाना
Hide Rows	पंक्तियों को छिपाना
Hide sheet	शीट् को छिपाना
Hide Subject	विषय को छिपाना
Hide Subpoints	अधीनविषयों को छिपाना
Hide Thread	त्रेड् छिपाना
Hide when printing	छपाई करने के समय छिपाना
Hide/Show Columns	स्तंभों को छिपाओ/दिखाओ
Hierarchical	हइरार्किकल
High	अधिक
Highest	सबसे अधिक
Highlight	विशेष प्रकार से दिखाओ
Highlight / Shadow	विशेष प्रकार से दिखाओ / छिपाओ
Highlight Changes	परिवर्तनों को विशेष प्रकार से दिखाओ
Highlight Fill	भरना विशेष प्रकार से दिखाओ
Highlighting	विशेष प्रकार से दिखा रहा है
Hindi	हिन्दी
Hiragana	हिरगाना
hit	मारना
hits	मारना
HLOOKUP	HLOOKUP
Holiday	छुट्टी का दिन
Home	होम्
Home directory	होम् डैरक्टरी
Homepage	मुख्य पृष्ठ
Homepage / e-mail	मुख्य पृष्ठ / इ-मेइल
Honduras	होन्डुरस
Hong Kong	हान्कान्ग
Horiz. Scrollbar	समतल स्क्रॉल पट्टी
Horizintal cones, percent	समतल शंकु, प्रतिशत
Horizontal	समतल
Horizontal alignment default	अनुपस्थिति में समतल पंक्तिकरण
Horizontal cones	समतल शंकु
Horizontal cones, deep	समतल शंकु, गहरा
Horizontal grid on/off	समतल जाल शुरु/बंद
horizontal line	समतल रेखा
Horizontal Line	समतल रेखा
Horizontal Lines	समतल रेखाएँ
Horizontal Pen	समतल कलम
Horizontal pitch	समतल पिच
Horizontal pyramids	समतल शुण्डाकार स्तंभ
Horizontal pyramids, deep	समतल शुण्डाकार स्तंभ, गहरा
Horizontal pyramids, percent	समतल शुण्डाकार स्तंभ, प्रतिशत
Horizontal pyramids, stacked	समतल शुण्डाकार स्तंभ, स्टॉक की हुयी
Horizontal ruler	समतल रूलर
Horizontal scroll	समतल स्क्रॉल
Horizontal scroll bar	समतल स्क्रॉल पट्टी
Horizontal shadow outline	समतल बाहरी रूपरेखा छाया
Horizontal text anchor	समतल टेक्स्ट् जोड़
Horizontal, stacked cones	समतल, स्टॉक की हुयी शंकु
Horizontally	समतल प्रकार से
horizontally	समतल प्रकार से
Horz. Scroll Bar	समतल स्क्रॉल पट्टी
Host	होस्ट्
HOUR	HOUR
Hours	घंटा
HTML	HTML
HTML (FrameSet)	HTML (फ्रेमसेट्ट)
HTML 3.2	HTML 3.2
HTML Document	HTML लेखपत्र
HTML Document Options	HTML लेखपत्र विकल्प
HTML Export	HTML आयात
HTML Import/Export	HTML आयात/निर्यात
HTML Source	HTML मूल
HTML source	HTML मूल
HTML source mode	HTML मूल प्रकार
HTML Styles	HTML शैलियाँ
HTTP	HTTP
Http Proxy	Http प्रॉक्सी
Http proxy port	Http प्रॉक्सी पोर्ट्
Http proxy server	Http प्रॉक्सी सर्वर
Hue	हयू
Hungarian	हन्गेरियन
Hungary	हन्गेरी
Hyperbolic Cosine	हाइपरबोलिक कोसैन
Hyperbolic Cotangent	हाइपरबोलिक कोटान्जेन्ट
Hyperbolic Sine	हाइपरबोलिक सैन
Hyperbolic Tangent	हाइपरबोलिक टान्जेन्ट
Hyperlink	हाइपरलिंक
Hyperlink Bar	हाइपरलिंक पट्टी
Hyperlink Dialog	हाइपरलिंक डयलॉग
Hyperlink end	हाइपरलिंक अंत
Hyperlink start	हाइपरलिंक प्रारंभ
Hyperlink type	हाइपरलिंक वर्ग
Hyperlinks	हाइपरलिंक
Hyperlinks Active	क्रियाशील हाइपरलिंक
HYPGEOMDIST	HYPGEOMDIST
Hyphenate	हाइफनेट् करना
Hyphenate special regions	विशेष प्रदेशों को हाइफनेट् करना
Hyphenation	हाइफनेशन
Hyphenation completed	हाइफनेशन समाप्त हुआ
Hyphenation not available	हाइफनेशन प्राप्य नहीं है
Hyphenation rules	हाइफनेशन नियम
Hyphens	हाइफन
I/O active	I/O क्रियाशील
IBM LAN	IBM LAN
iCalendar-File	iCalendar-फाइल
Iceland	अइसलान्ड
Icelandic	अइसलान्डिक
Icon	अइकॉन
Icon Spacing	अइकॉन का अंतर देना
Icon Text	अइकॉन टेक्स्ट्
Icon view	अइकॉन दृश्य
Icons	अइकॉन
ID	ID
Identification	पहचान
Identifier	अइडेन्टिफयर
Identifier expected	अइडेन्टिफयर की प्रतीक्षा
Identify categories	वर्गों की पहचान
IF	IF
Ignore	उपेक्षा करो
Ignore All	सब उपेक्षा करो
Ignore double spaces	द्विगुणित अंतर को उपेक्षा करो
Ignore empty rows	खाली पंक्तियों को उपेक्षा करो
Ignore font settings	अक्षर निर्धारण को उपेक्षा करो
Illumination	चमक
Illumination color	चमक का रंग
Illustration	दृष्टान्त
Illustration Index	दृष्टान्त अनुक्रमणी
Illustration Index Heading	दृष्टान्त अनुक्रमणी शीर्षक
Image	चित्र
Image	चित्र
Image Button	चित्र बटन
Image Control	चित्र नियंत्रण
Image map	चित्र नक्शा
Image Options	चित्र का विकल्प
Image preview (TIFF)	चित्र का पूर्वदृश्य (TIFF)
Image Properties	चित्र विशेषतायें
Image properties	चित्र विशेषतायें
Image size	चित्र परिमाण
Image Toolbar	चित्र की औज़ार पट्टी
ImageMap	चित्र नक्शा
ImageMap Editor	चित्र नक्शा संपादक
Imaginary Part	काल्पनिक भाग
IMAP	IMAP
IMAP Account	IMAP  हिसाब
Import	आयात
Import Bookmarks	पृष्ठसंकेत को आयात करो
Import Data	ड़ॉटा को आयात करो
Import DBase files	DBase  फाइलों को आयात करो
Import File	फाइल को आयात करो
Import Formula	सूत्र को आयात करो
Import formula	सूत्र को आयात करो
Import Lotus files	Lotus फाइलों को आयात करो
Import Personal Data	वैयक्तिक ड़ॉटा को आयात करो
Import Template	नमूने को आयात करो
Import text files	टेक्स्ट् फाइलों को आयात करो
Import vCard	vCard आयात करो
Important	महत्वपूर्ण
Important Information	महत्वपूर्ण सूचना
Important Note	महत्वपूर्ण टिप्पणी
Imported	निर्यात की हुयी
Imported calculation templates	निर्यात की हुयी गणना का नमूना
Imported presentation templates	निर्यात की हुयी प्रस्तुति का नमूना
Imported text templates	निर्यात की हुयी टेक्स्ट् नमूना
Importing	निर्यात करना
Importing document	लेखपत्र को निर्यात करना
Importing graphic	सुचित्र को निर्यात करना
Importing graphics	सुचित्रों को निर्यात करना
In Background	पृष्ठभाग में
in row	पंक्ति में
In the directory	डैरक्टरी में
inactive	निष्क्रिय
Inactive menu items	निष्क्रिय मेनु अइटम
Inadmissable path	प्रविष्टि न होने योग्य मार्ग
Inbox	इनबॉक्स
Inch	इन्च
Include	सम्मिलित करो
Include Dialogs	डयलॉगों को सम्मिलित करो
Include e-mail address	इ-मेइल पते को सम्मिलित करो
Include files (*.INC)	(*.INC) फाइलों को सम्मिलित करो
Include formats	रचना को सम्मिलित करो
Include subfolders	अधीन कोष्ठों को सम्मिलित करो
Included outline levels	बाहरी रूपरेखा स्तरों को सम्मिलित की हुयी
Including Styles	शैलियों को सम्मिलित करना
including subdirectories	अधीन डैरक्टरियों को सम्मिलित करना
Including Subfolders	अधीन कोष्ठों को सम्मिलित करना
Incoming mail	अंदर की ओर आनेवाला मेइल
Incorrect file mode	गलत फाइल प्रकार
Incorrect format	गलत रचना
Incorrect Password	गलत कूटशब्द
Incorrect property value	गलत विशेषता मूल्य
Incorrect record length	गलत अभिलेख विस्तार
Incorrect record number	गलत अभिलेख संख्या
Incr./Decrement value	मूल्य बढ़ाओ/घटाओ
Increase Font	फ़ॉन्ट बढाओ
Increase Indent	इन्डेन्ट बढाओ
Increase Spacing	बीच का अंतर बढाओ
Increment	बढती
Increment Indent Value	इन्डेन्ट मूल्य बढाओ
Increments	बढती
Indent	इन्डेन्ट
Indent left	बायाँ ओर इन्डेन्ट
Indent right	दाहिनी ओर इन्डेन्ट
Indented	इन्डेन्ट की हुयी
Indents	इन्डेन्ट्स
Indents Spacing	इन्डेन्ट का अंतर देना
INDEX	INDEX
Index	अनुक्रमणी
Index entries	अनुक्रमणी प्रविष्टि
Index Entry	अनुक्रमणी प्रविष्टि
Index entry	अनुक्रमणी प्रविष्टि
Index field	अनुक्रमणी क्षेत्र
Index Heading	अनुक्रमणी शीर्षक
Index identifier	अनुक्रमणी अइडेन्टिफयर
Index Link	अनुक्रमणी कड़ी
Index Markings	अनुक्रमणी चिह्न
Index marks	अनुक्रमणी चिह्न
Index name	अनुक्रमणी नाम
Index of Tables	सारणियों का अनुक्रमणी
Index Separator	अनुक्रमणी अलगानेवाला
Index Styles	अनुक्रमणी शैलियाँ
Indexes	अनुक्रमणी
Indexing	अनुक्रमणी देना
India	भारत
Indices	अनुक्रमणिका
INDIRECT	INDIRECT
Individual Words	अलग अलग शब्द
Individual words	अलग अलग शब्द
Indonesia	इन्डोनेशिया
Indonesian	इन्डोनेशियन
Infinity	अनन्त
Info	सूचना
Info fields	सूचना क्षेत्र
Info Fields	सूचना क्षेत्र
Information	सूचना
Inherited	इनहेरिट्
Initialize	इनीश्यलैज़
Initializing	इनीश्यलैज़ करना
Initials	इनीश्यल
inner	भीतरी
Inner	भीतरी
Inner frame border	भीतरी फ्रेम किनारा
Inner Join	भीतरी जोड़
Inner page border	भीतरी पृष्ठ किनारा
Inner paragraph border	भीतरी परिच्छेद किनारा
Inner wrap	भीतरी लपेटना
Inplace Translation	स्थानिक अनुवाद
Input	इनपुट्
Input field	इनपुट् क्षेत्र
Input field (user)	इनपुट् क्षेत्र (उपभोक्ता)
Input field (variable)	इनपुट् क्षेत्र (परिवर्तनीय)
Input file error	इनपुट् फाइल गलती
Input help	इनपुट् सहायता
Input Help	इनपुट् सहायता
Input in tables	सारणियों में इनपुट्
Input line	इनपुट् रेखा
Input Options	इनपुट् विकल्प
Input required	इनपुट् की आवश्यकता
Inquire	जाँचना
Inscription	नक्श
Insert	जोड़ो
Insert Applet	एप्लेट् जोड़ो
Insert as	जोड़ो जैसे
Insert as Copy	प्रतिलिपि जैसे जोड़ो
Insert as copy	प्रतिलिपि जैसे जोड़ो
Insert as Hyperlink	हाइपरलिंक जैसे जोड़ो
Insert as hyperlink	हाइपरलिंक जैसे जोड़ो
Insert as Link	कड़ी जैसे जोड़ो
Insert as link	कड़ी जैसे जोड़ो
Insert Author Field	लेखक क्षेत्र जोड़ो
Insert AutoText	स्वचालित टेक्स्ट् जोड़ो
Insert Axes	अक्षरेखाओं को जोड़ो
Insert BASIC Source	BASIC मूल को जोड़ो
Insert before	से पहिले जोड़ो
Insert bibliography entry	ग्रन्थ-सूची प्रविष्टि जोड़ो
Insert Bookmark	पृष्ठसंकेत जोड़ो
Insert Break	खण्डन जोड़ो
Insert business cards	व्यवहार कार्ड जोड़ो
Insert caption	कॉप्शन् जोड़ो
Insert Cells	कोष्ठों को जोड़ो
Insert Cells Down	नीचे की ओर कोष्ठों को जोड़ो
Insert Cells Right	दाहिनी ओर कोष्ठों को जोड़ो
Insert Chart	चार्ट जोड़ो
Insert Column	स्तंभ जोड़ो
Insert Column Break	स्तंभ खण्डन जोड़ो
Insert Columns	स्तंभों को जोड़ो
Insert Command	निर्देश जोड़ो
Insert Comment	अपवाद जोड़ो
Insert Controls	नियंत्रणों को जोड़ो
Insert data	ड़ॉटा जोड़ो
Insert data as	ड़ॉटा जोड़ो जैसे
Insert Data Caption	ड़ॉटा कॉप्शन् जोड़ो
Insert data label	डॉटा लेबिल जोड़ो
Insert Database Columns	लेखासंचय स्तंभों को जोड़ो
Insert Date	दिनांक जोड़ो
Insert document	लेखपत्र जोड़ो
Insert Document Title	लेखपत्र शीर्षक जोड़ो
Insert Draw Object	खींचने का वस्तु जोड़ो
Insert Endnote Directly	अंतिम टीका को सीधा जोड़ो
Insert Envelope	लिफाफा जोड़ो
Insert Field Reference	क्षेत्र रेफरेन्स जोड़ो
Insert Fields	क्षेत्रों को जोड़ो
Insert File	फाइल जोड़ो
Insert File Field	फाइल का क्षेत्र जोड़ो
Insert Floating Frame	फ्लोटिंग फ्रेम जोड़ो
Insert Footer	पृष्ठ के अधोभाग की टीका जोड़ो
Insert Footnote	पृष्ठ के नीचे की टीका जोड़ो
Insert Footnote Directly	पृष्ठ के नीचे की टीका को सीधा जोड़ो
Insert Formula	सूत्र जोड़ो
Insert frame	फ्रेम जोड़ो
Insert Frame Manually	फ्रेम को मान्युवली जोड़ो
Insert Function	फंक्शन् जोड़ो
Insert Glue Point	ग्लु बिन्दु जोड़ो
Insert graphics	सुचित्रों को जोड़ो
Insert Graphics	सुचित्रों को जोड़ो
Insert grids	जालों को जोड़ो
Insert Group	समूह जोड़ो
Insert Header	शीर्षक जोड़ो
Insert Horizontal	समतल जोड़ो
Insert Horizontal Ruler	समतल रूलर जोड़ो
Insert Horizontally	समतल प्रकार से जोड़ो
Insert Hyperlink	हाइपरलिंक जोड़ो
Insert Image	चित्र जोड़ो
Insert in container	कन्टेनर में जोड़ो
Insert index	अनुक्रमणी जोड़ो
Insert Index Entry	अनुक्रमणी प्रविष्टि जोड़ो
Insert Index Marker	अनुक्रमणी सूचित करनेवाले को जोड़ो
Insert Join	जाइन जोड़ो
Insert Label Ranges	लेबिल फैलाव जोड़ो
Insert Labels	लेबिलों को जोड़ो
Insert Layer	परत जोड़ो
Insert legend	लेजन्ड जोड़ो
Insert Link	कड़ी जोड़ो
Insert Manual Break	मान्युवल खण्डन जोड़ो
Insert Matrix Formula	कोष्ठ वर्ग सूत्र जोड़ो
Insert Mode	प्रकार जोड़ो
Insert Name	नाम् जोड़ो
Insert new row	नया पंक्ति जोड़ो
Insert Non-breaking Hyphen	बिना-खण्डन का हाइफन जोड़ो
Insert Non-breaking Space	बिना-खण्डन का अंतर जोड़ो
Insert note	टिप्पणी जोड़ो
Insert numbering	संख्या दने का ऑप्शन् जोड़ो
Insert Object	वस्तु जोड़ो
Insert object	वस्तु जोड़ो
Insert object(s)	वस्तु जोड़ो
Insert Objects	वस्तुओं को जोड़ो
Insert OLE Object	OLE वस्तु जोड़ो
Insert Optional Hyphen	वैकल्पिक हाइफन जोड़ो
Insert Other Objects	अन्य वस्तुओं को जोड़ो
Insert page	पृष्ठ जोड़ो
Insert Page Count	पृष्ठ गिनती जोड़ो
Insert Page Field	पृष्ठ क्षेत्र जोड़ो
Insert Page Number	पृष्ठ संख्या जोड़ो
Insert Paragraph	परिच्छेद जोड़ो
Insert Plug-In	प्लग-ईन जोड़ो
Insert Point	बिन्दु जोड़ो
Insert Points	बिन्दुओं को जोड़ो
Insert Query Data	जानकारी ड़ॉटा जोड़ो
Insert Reference	रेफरेन्स जोड़ो
Insert result (	नतीजा जोड़ो (
Insert row	पंक्ति जोड़ो
Insert Row	पंक्ति जोड़ो
Insert Row Break	पंक्ति खण्डन जोड़ो
Insert Rows	पंक्तियों को जोड़ो
Insert ruler	रूलर जोड़ो
Insert Script	स्क्रिप्ट् जोड़ो
Insert Section	विभाग जोड़ो
Insert Sheet	शीट् जोड़ो
Insert Signature	हस्ताक्षर जोड़ो
Insert Slide	स्लइड जोड़ो
Insert Slide Direct	स्लइड को सीधा जोड़ो
Insert slides	स्लइडों को जोड़ो
Insert Slides/Objects	स्लइडों/वस्तुओं को जोड़ो
Insert Snap Point/Line	स्नॉप बिन्दु/रेखा जोड़ो
Insert sound	ध्वनि जोड़ो
Insert Sound PlugIn	ध्वनि प्लग-ईन जोड़ो
Insert Source Text	मूल टेक्स्ट् जोड़ो
Insert Special Character	विशेष अक्षर जोड़ो
Insert special character	विशेष अक्षर जोड़ो
Insert Subject	विषय जोड़ो
Insert Table	सारणी जोड़ो
Insert Text	टेक्स्ट् जोड़ो
Insert text	टेक्स्ट् जोड़ो
Insert text frame	टेक्स्ट् फ्रेम जोड़ो
Insert Text Frame	टेक्स्ट् फ्रेम जोड़ो
Insert Time	समय जोड़ो
Insert title	शीर्षक जोड़ो
Insert Unnumbered Entry	संख्या रहित प्रविष्टि जोड़ो
insert URL button	URL बटन जोड़ो
Insert Version Comment	आवर्तन अपवाद जोड़ो
Insert Vertical	लंबरूप जोड़ो
Insert Vertically	लंबरूप प्रकार से जोड़ो
Insert video	विडियो जोड़ो
Insert Video PlugIn	विडियो प्लग-ईन जोड़ो
Insert/remove primary key	प्रैमरी की जोड़ो/हटाओ
Inserted	जोड़ा हुआ
Inserting Index	अनुक्रमणी जोड़ना
Insertions	जोड़
Inside	भीतरी ओर
inside (centered)	भीतरी ओर (केन्द्रित)
INSRT	INSRT
Install	प्रतिष्ठापित करना
Install user now.	अभी उपभोक्ता को प्रतिष्ठापित करो
install.ini	install.ini
Installation	प्रतिष्ठापन
Installation Complete	प्रतिष्ठापन समाप्त हुआ
Installation program	प्रतिष्ठापन प्रोग्राम
Installing daemons	डेमन्स प्रतिष्ठापित करना
Institution	संस्था
Insufficient memory	अपर्याप्त मेमरी
INT	INT
Integer	पूर्णांक
Integers Set	पूर्णांक समूह
Integral	समस्त
Intended recipient	उद्धेशित प्रतिग्राहक
Intended recipient unknown	अज्ञात उद्धेशित प्रतिग्राहक
Intensity	तीव्रता
Interaction	परस्पर सम्बन्ध का कार्य
INTERCEPT	INTERCEPT
Interchange (EPSI)	अदला बदला करना (EPSI)
Interface not supported	इन्टरफेस असमर्थित
Interlaced	इन्टरलेस्ड
Internal	भीतरी
Internal import error	भीतरी निर्यात गलती
Internal Memo	भीतरी स्मृतिपत्र
Internal syntactical error	भीतरी सिन्टाक्टिकल गलती
Internal time value	भीतरी समय मूल्य
Internet	इन्टरनेट्
Internet (e-mail)	इन्टरनेट् (इ-मेइल)
Internet Bar	इन्टरनेट् पट्टी
Internet document	इन्टरनेट् लेखपत्र
Internet Document	इन्टरनेट् लेखपत्र
Internet Link	इन्टरनेट् कड़ी
Internet Online/Offline	इन्टरनेट् ऑनलैन/ऑफलैन
Internet Options	इन्टरनेट् विकल्प
Interoffice Memo	इन्टर ओफीस स्मृतिपत्र
Interpolation	इन्टरपोलेशन
Interrupt	रोकना
Interrupt Macro	मॉक्रो रोकना
Intersect	प्रतिच्छेद
intersection	प्रतिच्छेद
Interval	अंतराल
invalid	अमान्य
Invalid	अमान्य
Invalid bookmark value!	अमान्य पृष्ठसंकेत मूल्य!
Invalid clipboard format	अमान्य क्लिपबोर्ड रचना
Invalid data length	अमान्य ड़ॉटा विस्तार
Invalid database connection	अमान्य लेखासंचय कनेक्शन
Invalid expression	अमान्य वर्णन
Invalid expression	अमान्य वर्णन
Invalid index	अमान्य अनुक्रमणी
Invalid message ID	अमान्य सन्देश ID
Invalid Name	अमान्य नाम
Invalid name	अमान्य नाम
Invalid number	अमान्य संख्या
Invalid object index	अमान्य वस्तु अनुक्रमणी
Invalid object reference	अमान्य वस्तु रेफरेन्स
Invalid ordinal number	अमान्य ओर्डिनल संख्या
Invalid parameter	अमान्य पैरामीटर
Invalid Parameters	अमान्य पैरामीटर
Invalid password	अमान्य कूटशब्द
Invalid print range	अमान्य छपाई फैलाव
Invalid procedure call	अमान्य कार्यप्रणाली बुलावा
Invalid range	अमान्य फैलाव
Invalid range variable	अमान्य फैलाव परिवर्ती
Invalid sheet name	अमान्य शीट् नाम
Invalid sheet reference	अमान्य शीट् रेफरेन्स
Invalid string pattern	अमान्य अक्षर नमूना
Invalid Target Directory	अमान्य लक्ष्य डैरक्टरी
Invalid target value	अमान्य लक्ष्य मूल्य
Invalid value	अमान्य मूल्य
Invert	उलटा करो
Invisible	अगोचर
Invite automatically	स्वचालित प्रकार से न्योता देना
Inward margin	भीतरी ओर सीमा
IPA Extensions	IPA विस्तार
IPMT	IPMT
Ireland	अयर्लान्ड
Irish Punt	अइरिश पन्ट
IRR	IRR
Is Approximately Equal	सदृश समान
Is congruent to	अनुरूप
Is Equal	समान
Is Greater Than	से अधिक
Is In	में
Is Less Than	से कम
Is Not Equal	असमान
Is Not In	में नहीं
Is not Null	नल नहीं
Is Null	नल
Is Orthogonal to	समकोणाकार
Is Parallel To	समानान्तर
Is Proportional To	अनुरूप
Is Similar to	सदृश
ISBLANK	ISBLANK
ISBN	ISBN
ISERR	ISERR
ISERR	ISERR
ISERR	ISERR
ISFORMULA	ISFORMULA
IsLeapYear	IsLeapYear
ISLOGICAL	ISLOGICAL
ISNA	ISNA
ISNONTEXT	ISNONTEXT
ISNUMBER	ISNUMBER
ISODD	ISODD
Israel	इस्रएल
ISREF	ISREF
ISTEXT	ISTEXT
Italian	इटालियन
Italian (CH)	इटालियन (CH)
Italian Lira	इटालियन
Italic	ढेड़ा
Italic Font	ढेड़ा अक्षर
italic off	ढेड़ा बंद
italic on	ढेड़ा शुरू
Italy	इटली
Item Browser on/off	अइटम ब्रउज़र शुरु/बंद
Item status changed	अइटम वस्तुस्थिति बदल गया
Iterations	पुनरुक्ति
Iterative references	पुनरुक्ति रेफरेन्स
Jamaika	जमैका
Jan	जनवरी
January	जनवरी
Japan	जपान
Japanese	जपानीस
JAR file	JAR फाइल
Java	Java
Java Environment Installation	Java पर्यावरण प्रतिष्ठापन
Java Setup	जावा सेटप
JavaScript	जावा स्क्रिप्ट्
JavaScript is busy	जावा स्क्रिप्ट्
JavaScript runtime error	जावा स्क्रिप्ट् चलने के समय गलती
JDBC	JDBC
JDBC driver class	JDBC ड्रइवर वर्ग
Join Properties	जोड़ विशेषतायें
Jordan	जोर्डन
Journal	जर्नल
JPEG Options	JPEG विकल्प
Jul	जुलाई
July	जुलाई
Jun	जून
June	जून
Justified	व्यवस्था की हुयी
Justify	व्यवस्था करना
Kannada	कन्नडा
Kashmiri	काश्मीरि
Kashmiri (India)	काश्मीरि (भारत)
Katakana	कटकाना
Kazak	कझाक
Kazakhstan	कझाखस्तान
KB	KB
kByte	के बइट्
Keep filter criteria	फिल्टर सिद्धान्त रखो
Keep formatting	रचना करते रहना
Keep ratio	अनुपात रखना
Keep scale	स्केल रखना
Keep size	परिमाण रखना
Keep spacing interval	बीच की अंतर की अंतराल रखना
Kerning	केर्निन्ग
Key	की
Key 1	की 1
Key 2	की 2
Key 3	की 3
Key released	की मुक्त करना
Key type	की दबना
Key typed	की दबाया
Key word	प्रधान शब्द
Key words	प्रधान शब्द
Keys	की
Keywords	प्रधान शब्द
Khmer	ख्मेर
Kilometer	किलोमीटर
Konkani	कोन्कनी
Korean	कोरियन
Korean (Johab)	कोरियन (जोहाब)
KURT	KURT
Kuwait	कुवैट्
Label	लेबिल
Label expected	लेबिल की प्रतीक्षा
Label field	लेबिल क्षेत्र
Label Field Selection	लेबिल क्षेत्र चुनाव
Label Settings	लेबिल निर्धारण
Label text	लेबिल टेक्स्ट्
Labels	लेबिल
lambda	लाम्डा
Lambda Bar	लाम्डा पट्टी
Landscape	लान्डस्केप
Language	भाषा
Language not supported	भाषा समर्थित नहीं है
Lao	लाओ
LARGE	LARGE
Large buttons	बडा बटनें
Large Circumflex	बडा सर्कमफ्लेक्स
Large control points	बडा नियंत्रण बिन्दु
Large Icons	बडा अइकॉन
Large Tilde	बडा टिल्ड
Large Vector Arrow	बडा वेक्टर तीर
Largest	सबसे बडा
Laser	लेसर
Last line	अंतिम रेखा
last modified %1	अंतिम परिवर्तन %1
Last Name	अंतिम नाम
Last name	अंतिम नाम
Last page	अंतिम पृष्ठ
Last Page	अंतिम पृष्ठ
Last printed	अंतिम छपाई किया गया
Last Record	अंतिम अभिलेख
Last Used	अंतिम उपयोग किया गया
Last Version	अंतिम आवर्तन
Last Window Size	अंतिम विन्डो परिमाण
Latin Extended Additionals	लेटिन अधिकतर विस्तृत
Latin Extended-A	लेटिन विस्तृत-A
Latin Extended-B	लेटिन विस्तृत-B
Latin-1	लेटिन-1
Latvia	लॉट्विया
Latvian	लॉट्वियन
Lavender	लॉवेन्डर
Layer	परत
Layer Indicator	परत निदर्शक
Layer view	परत दृश्य
Layout	अभिन्यास
Layout 1	अभिन्यास 1
Layout 2	अभिन्यास 2
Layout 3	अभिन्यास 3
Layout 4	अभिन्यास 4
LCM	LCM
LDAP Server	LDAP सर्वर
LE	LE
Leader	अग्रसर
Leading	अग्र
Leading zeroes	अग्र शून्याएँ
Leaves	पत्ता
Lebanon	लेबनॉन
left	बायाँ
Left	बायाँ
LEFT	LEFT
Left A	बायाँ A
Left Arc	बायाँ चाप
Left Area	बायाँ विस्तीर्ण
Left Arrow	बायाँ तीर
Left B	बायाँ B
Left border spacing	बायाँ किनारे में अन्तर देना
Left column	बायाँ स्तंभ
Left frame border	बायाँ फ्रेम किनारा
Left guide	बायाँ सहायक
Left Join	बायाँ जोड़
Left limit expected	बायाँ सीमा की प्रतीक्षा
Left margin	बायाँ पृष्ठ-प्रान्त
left outside	बायाँ बाहरी ओर
Left Page	बायाँ पृष्ठ
Left page border	बायाँ पृष्ठ किनारा
Left pages	बायाँ
Left paragraph border	बायाँ परिच्छेद किनारा
Left paragraph margin	बायाँ परिच्छेद-प्रान्त
Left Semicircle	बायाँ अर्धवृत्त
Left to right	बायाँ ओर से दाहिनी ओर
Left wrap	बायाँ लपेटना
Left;Center;Right	बायाँ;मध्यभाग;दाहिना
Left;Middle;Right	बायाँ;मध्यभाग;दाहिना
Legend	लेजन्ड
Legend angle	लेजन्ड कोण
Legend attributes	लेजन्ड ऐट्रिब्यूट्
Legend exit alignment	लेजन्ड निर्गम पंक्तिकरण
Legend line length	लेजन्ड रेखा विस्तार
Legend lines spacing	लेजन्ड रेखा अंतर
Legend on/off	लेजन्ड शुरु/बंद
Legend Position	लेजन्ड स्थान
Legend reserved 5	लेजन्ड 5 केलिए रक्षित
LEN	LEN
Length	विस्तार
length	विस्तार
Less	कम
Less Blue	कम नीला
Less Brightness	कम चमकीलापन
Less Contrast	कम भेद दिखलाना
Less Green	कम हरा
Less Red	कम लाल
less than	से कम
Letter	अक्षर
Letterlike Symbols	अक्षर जैसे संकेत
Level	सतह
Level ID	सतह ID
Levels	स्तरें
LF	LF
Libraries	लैब्ररियाँ
Library	लैब्ररी
License Agreement	अनुज्ञप्ति स्वीकारपत्र
Liechtenstein	लैचटेन्स्टीन
Life	जीवन
light	हल्का
Light	हल्का
Light blue	हल्का नीला
Light cyan	हल्का सियान
Light gray	हल्का ग्रे
Light green	हल्का हरा
Light Italic	हल्का ढेड़ा
Light magenta	हल्का मेजन्टा
Light red	हल्का लाल
Light source	हल्का मूल
like	समान
Limes	लइमस
Limits	सीमा
Line	रेखा
Line Above	ऊपरी रेखा
Line arrow	तीर रेखा
Line attributes	रेखा ऐट्रिब्यूट्स
Line Below	नीचे की रेखा
Line break	रेखा खण्डन
Line centered	केन्द्रित रेखा
Line Color	रेखा की रंग
Line color	रेखा की रंग
Line Connector	रेखा कनेक्टर
Line Contour Only	केवल रेखा परिवेश
Line contour only	केवल रेखा परिवेश
Line count	रेखा गिनना
Line Dash/Dot	रेखा डॉश/बिन्दु
Line distance	रेखा दूरी
Line end	रेखा अंत
Line end width	रेखा अंत चौड़ाई
Line head	रेखा प्रारंभ
Line head width	रेखा प्रारंभ चौड़ाई
Line joint	रेखा जोड़
Line joint averaged	रेखा जोड़ की माध्य
Line joint bevel	रेखा की जोड़ तिरछा
Line joint miter	रेखा की जोड़ अल्प मात्रा
Line joint round	रेखा की जोड़ गोल
Line length	रेखा विस्तार
Line Numbering	रेखा को संख्या देना
Line Over	रेखा ऊपर
Line pattern	रेखा नमूना
Line skew	रेखा स्क्यू
Line Spacing	रेखा अंतर देना
Line spacing	रेखा अंतर देना
Line Style	रेखा शैली
Line style	रेखा शैली
Line Through	रेखा अंत तक
Line Tool	रेखा औज़ार
Line transparency	रेखा पारदर्शकता
Line Type	रेखा वर्ग
Line type	रेखा वर्ग
Line Width	रेखा चौड़ाई
Line width	रेखा चौड़ाई
Line with Arrow/Circle	तीर/वृत्त सहित रेखा
Line with Arrow/Square	तीर/समचतुर्भुज सहित रेखा
Line with Arrows	तीरों सहित रेखा
Line with Circle/Arrow	वृत्त/तीर सहित रेखा
Line with Square/Arrow	समचतुर्भुज/तीर सहित रेखा
Linear	संकुचित
Linear ascending	संकुचित आरोहण क्रम
Linear bluewhite	संकुचित काला/सफेद
Linear descending	संकुचित अवरोहण
Linear magenta/green	संकुचित मेजन्टा/हरा
Linear regression	संकुचित रिग्रेश्यन
Linear transparency	संकुचित पारदर्शकता
Linear yellow/brown	संकुचित पीला/भूरा
Linear_type	संकुचित_वर्ग
Linen	लिनन
Lines	रेखाएँ
Lines and Arrows	रेखाएँ और तीरें
Lines changed	बदला हुआ रेखाएँ
Lines Only	केवल रेखाएँ
Lines with Symbols	संकेतों सहित रेखाएँ
LINEST	LINEST
Link	कड़ी
Link Frames	फ्रेम् को लिंक करो
Link graphics	सुचित्रों को लिंक करो
Link text frames	टेक्स्ट् फ्रेम को लिंक करो
Link to	को लिंक करो
Link to file	फाइल को लिंक करो
Linked areas	लिंक की हुयी विस्तीर्ण
Linked Bitmap	लिंक की हुयी बिटमॉप्
Linked bitmaps	लिंक की हुयी बिटमॉप्
Linked graphic	लिंक की हुयी सुचित्र
Linked graphics	लिंक की हुयी सुचित्र
Linked group object	लिंक की हुयी समूह वस्तु
Linked group objects	लिंक की हुयी समूह वस्तु
Linked Mac graphic	लिंक की हुयी Mac सुचित्र
Linked Mac graphics	लिंक की हुयी Mac सुचित्र
Linked Metafile	लिंक की हुयी मेटाफाइल
Linked Metafiles	लिंक की हुयी मेटाफाइलें
Linked text frame	लिंक की हुयी टेक्स्ट् फ्रेम
Linked text frames	लिंक की हुयी टेक्स्ट् फ्रेम
linked to	केलिए लिंक की हुयी
Linking	लिंक करना
Links	लिंक्स
Linux	Linux
List	सूची
List Box	सूची बॉक्स
List Box On/Off	सूची बॉक्स शुरु/बंद
List content	सूची विषय
List Contents	सूची विषय
List entries	सूची प्रविष्टि
List from	से सूची
List Heading	सूची शीर्षक
List Indent	सूची इन्डेन्ट
List Index	सूची अनुक्रमणी
List names	सूची नाम
List Separator	सूची अलगानेवाला
List Styles	सूची शैलियाँ
Lists	सूची
Literal mask	लिटरल मास्क
Lithuania	लिथुवानिया
Lithuanian	लिथुवानियन
Lithuanian (Classical)	लिथुवानियन (क्लासिकल)
Live Mode	प्रत्यक्ष प्रकार
Ln	एल एन
Load	लोड करो
Load backup	बैकप लोड करो
Load Balancer Master	लोड संतुलन मास्टर
Load Configuration	रूपरेखा लोड करो
Load configuration files	रूपरेखा फाइलों को लोड करो
Load data	ड़ॉटा लोड करो
Load document	लेखपत्र लोड करो
Load Document	लेखपत्र लोड करो
Load from Template	नमूने से लोड करो
Load Graphics	सुचित्रों को लोड करो
Load Keyboard Configuration	कीबोर्ड रूपरेखा लोड करो
Load Library	लैब्ररी लोड करो
Load Menu Configuration	मेनु रूपरेखा लोड करो
Load Slide Design	स्लइड डिसैन लोड करो
Load Template	नमूना लोड करो
Load Templates	नमूनों को लोड करो
Load Toolbar Configuration	औज़ार पट्टी का रूपरेखा लोड करो
Load URL	URL लोड करो
Load/Save Group List	समूह सूची को लोड करो/संचित करो
Load/Save Group list	समूह सूची लोड करना/संचित करो
Loading	लोड करना
Loading document	लेखपत्र लोड हो रहा है
Loading Document	लेखपत्र लोड हो रहा है
Loading messages	सन्देशों को लोड कर रहा है
Loading newsgroups	समाचार वर्गों को लोड कर रहा है
local data sources	स्थानिक ड़ॉटा मूल
Local drive	स्थानिक ड्रइव्
Local file system	स्थानिक फाइल सिस्टम
Location	स्थान
locked	ताला लगा हुआ
Locked	ताला लगा हुआ
Locking problem	ताला लगाने में कठिनाई
Log file	लॉग फाइल
Log home directory	लॉग होम डैरक्टरी
Log Out	लॉग औट्
Logarithm	लघुगणक
Logarithm regression	लघुगणक रिग्रेश्यन
Logarithmic scale	लघुगणकविधि-सम्बन्धी स्केल
LOGEST	LOGEST
Logging out	लॉग औट् करना
Logical	तर्कानुसार
Logical height	तर्कानुसार ऊँचाई
Logical value	तर्कानुसार मूल्य
Logical width	तर्कानुसार चौड़ाई
Login	लॉग इन
Login again	फिर से लॉग इन
Login as anonymous	अज्ञात जैसे लॉग इन
Login name	लॉग इन नाम
LOGINV	LOGINV
LOGNORMDIST	LOGNORMDIST
Logo	संकेत
Logo text	संकेत टेक्स्ट्
Long Dash	लम्बा डॉश
Long Dash (Bold)	लम्बा डॉश (खडा)
Long table names	लम्बा सारणी की नाम
Look Feel	देखने का अनुभव करना
LOOKUP	LOOKUP
lookup_array	लुकप_श्रेणी
Loop suggestions	लूप सुझाव
Low	कम
Lower	निचला
LOWER	LOWER
Lower Arc	निचला चाप
Lower border spacing	निचला किनारे में अंतर जहा  देना
Lower case	लोवर केस
Lower Case	लोवर केस
Lower case only	केवल लोवर केस
Lower case Roman	लोवर केस रोमन
Lower edge dimensioning	निचला किनारे को परिमाण देना
Lower Indicator	निचला निदर्शक
Lower limit	निचला सीमा
Lower Limit	निचला सीमा
Lower Semicircle	निचला अर्धवृत्त
Lowercase	लोवर केस
Lowest	सबसे कम
Lowest common multiple	न्यूनतम सामान्य अपवर्त्य
LS	LS
ltr	एलटिआर
Luxembourg	लक्सेम्बर्ग
Luxembourg Franc	लक्सेम्बर्ग फ्रान्क
LZW encoding	LZW ऐनकोडिंग
Mac graphic	Mac सुचित्र
Mac graphics	Mac सुचित्र
MAC Text	MAC टेक्स्ट्
Macedonia	मेसिडोनिया
Macedonian	मेसिडोनियन
Macintosh	Macintosh
Mac-Picture	Mac-चित्र
Macro	मॉक्रो
Macro Bar	मॉक्रो पट्टी
Macro Dialog	मॉक्रो डयलॉग
Macro file	मॉक्रो फाइल
Macro from	से मॉक्रो
Macro name	मॉक्रो नाम्
Macro Organizer	मॉक्रो व्यवस्थापक
Macro Toolbar On/Off	मॉक्रो औज़ार पट्टी शुरु/बंद
Macros	मॉक्रोस
Magazine	पत्रिका
Magazine Article	पत्रिका लेख
Magenta	मेजन्टा
Mail Format	मेइल रचना
Mail News	मेइल समाचार
Mail Toolbar	मेइल औज़ार पट्टी
Mail Toolbar	मेइल औज़ार पट्टी
Mail/News	मेइल/समाचार
Mail/News Storage	मेइल/समाचार संग्रह
Main entry	मुख्य प्रविष्टि
Main grid	मुख्य जाल
Main index entry	मुख्य अनुक्रमणी प्रविष्टि
Main Title	मुख्य शीर्षक
Main Toolbar	मुख्य औज़ार पट्टी
Main Toolbar On/Off	मुख्य औज़ार पट्टी शुरु/बंद
Main Toolbar/Web	मुख्य औज़ार पट्टी/वेब
Major axis	प्रधान अक्षरेखा
Major Interval	प्रधान अंतराल
Make object invisible	वस्तु को अगोचर बनाओ
Malay	मलय
Malay (Brunei Darusalam)	मलय (ब्रूनि दरुसलाम)
Malay (Malaysia)	मलय (मलेशिया)
Malayalam	मलयालम
Malaysia	मलेशिया
Malaysian	मलेशियन
Malta	माल्टा
Manager	प्रबन्धक
Manipuri	मनिपुरि
Manual	मान्युवल
Manual Break	मान्युवल खण्डन
Manual browser settings	मान्युवल ब्रउज़र निर्धारण
Manual e-mail settings	मान्युवल इ-मेइल निर्धारण
Manual feed	मान्युवल फीड
Manual kerning	मान्युवल केर्निंग
Manual news settings	मान्युवल समचार निर्धारण
Manual setting	मान्युवल निर्धारण
MAPI	MAPI
Maps	नक्शा
Mar	मार्च
Marathi	मराथि
Marble	संगमरमर
March	मार्च
Margin	सीमा
Marginalia	मार्जिनालिया
Margins	सीमा
Mark	चिह्नित करो
Mark additional objects	अधिकतर वस्तुओं को चिह्नित करो
Mark additional points	अधिकतर बिन्दुओं को चिह्नित करो
Mark glue points	ग्लू बिन्दुओं को चिह्नित करो
Mark invalid data	अमान्य ड़ॉटा को चिह्नित करो
Mark Invalid Data	अमान्य ड़ॉटा को चिह्नित करो
Mark Message	सन्देश को चिह्नित करो
Mark objects	वस्तुओं को चिह्नित करो
Mark points	बिन्दुओं को चिह्नित करो
Mark read	पढ़ने का ऑप्शन् को चिह्नित करो
Mark Thread	त्रेड को चिह्नित करो
Mark thread read	त्रेड का पढ़ने का ऑप्शन् को चिह्नित करो
Mark Thread Read	त्रेड का पढ़ने का ऑप्शन् को चिह्नित करो
Mark Thread Unread	त्रेड का बिना पढ़ने का ऑप्शन् को चिह्नित करो
Mark Threads	त्रेड को चिह्नित करो
Mark Threads Unread	त्रेड का बिना पढ़ने का ऑप्शन् को चिह्नित करो
Mark unread	बिना पढ़ने का ऑप्शन् को चिह्नित करो
Marked	चिह्नित की हुयी
Marked Documents	चिह्नित की हुयी लेखपत्र
Marked Messages	चिह्नित की हुयी सन्देश
marked only	केवल चिह्नित की हुयी
Marked or unread	चिह्नित की हुयी अथवा बिना पढ़ा हुआ
Marking messages	सन्देशों को चिह्नित करना
Marocco	मोरोक्को
Master Document	मास्टर लेखपत्र
Master View	मास्टर दृश्य
MATCH	MATCH
Match case	केस तुलना
Material	पदार्थ
Material Properties	पदार्थ विशेषतायें
Math	गणित
Mathematical	गणित सम्बन्धी
Mathematical Operators	गणित सम्बन्धी प्रवर्तक
Matrix	कोष्ठ वर्ग
Matrix Stack	कोष्ठ वर्ग स्टॉक
Matrixes	कोष्ठ वर्ग
Mauritius	मोरिशस
Max	अधिकतम
Max.	अधिकतम
Max. entries	अधिकतम प्रविष्टियाँ
Max. footnote area	पृष्ठ के नीचे की टीका का अधिकतम विस्तीर्ण
Max. frame height	फ्रेम का अधिकतम ऊँचाई
Max. frame width	फ्रेम का अधिकतम चौड़ाई
Max. text length	टेक्स्ट् का अधिकतम विस्तार
MAXA	MAXA
Maximal frame height	फ्रेम का अधिकतम ऊँचाई
Maximal frame width	फ्रेम का अधिकतम चौड़ाई
Maximize Window	विन्डो बडा करो
Maximum	अधिकतम
Maximum footnote height	पृष्ठ के नीचे की टीका का अधिकतम ऊँचाई
Maximum matches	अधिकतम तुलना
May	मेइ
MB	MB
MDETERM	MDETERM
MDI Window	MDI विन्डो
Mean	माध्य
mean	माध्य
Mean value	माध्य मूल्य
Meaning	अर्थ
Meas. units	नाप यूनिट्
Measure unit	नाप यूनिट्
Measure unit display	नाप यूनिट् प्रदर्शन
Measurement unit	नाप यूनिट्
Media Key	मीडिया की
MEDIAN	MEDIAN
Medium	मीडियम
medium	मीडियम
memo	स्मृतिपत्र
Memo file	स्मृतिपत्र फाइल
Memorandum	मेमोरन्डम
Memory	मेमरी
Memory cache	मेमरी कॉश
Menu	मेनु
Mercury	मर्कुरी
Merge	मिलाओ
Merge Cells	कोष्ठों को मिलाओ
Merge Document	लेखपत्र को मिलाओ
Merge Documents	लेखपत्रों को मिलाओ
Merge table	सारणी को मिलाओ
Merge Table	सारणी को मिलाओ
Merge Tables	सारणियों को मिलाओ
Message	सन्देश
Message ID	सन्देश ID
Message Read/Unread	सन्देश पढ़ा हुआ/बिना पढ़ा हुआ
Message received	प्राप्त सन्देश
Message text	सन्देश टेक्स्ट्
message/rfc822	सन्देश/आर एफ् सि822
messages	सन्देश
Messages	सन्देश
MET Options	MET विकल्प
Metafile	मेटा फाइल
Metafiles	मेटा फाइलें
Metal	धातु
Meter	मीटर
Method	मेथड
Mexico	मेक्सिको
Mid	मिड
MID	MID
MIDI	MIDI
Miles	मैल
Millimeter	मिल्ली मीटर
Mime type	मइम वर्ग
MIME Type	MIME वर्ग
MIME Version	MIME आवर्तन
Min	न्यूनतम
Min. frame height	न्यूनतम फ्रेम ऊँचाई
Min. frame width	न्यूनतम फ्रेम चौड़ाई
Min. height	न्यूनतम ऊँचाई
Min. word length	न्यूनतम शब्द विस्तार
MINA	MINA
Minimal frame width	न्यूनतम फ्रेम चौड़ाई
Minimize all	सब को छोटा करो
Minimize All Windows	सब विन्डों को छोटा करो
Minimize Window	विन्डो को छोटा करो
Minimum	न्यूनतम
Minimum Change	न्यूनतम परिवर्तन
Minimum Installation	न्यूनतम प्रतिष्ठापन
Minimum length	न्यूनतम विस्तार
Minimum size	न्यूनतम परिमाण
Minimum spacing	न्यूनतम अंतर
Minor grid	अमुख्य जाल
Minor Interval	अमुख्य अंतराल
Minor X Grid	अमुख्य X जाल
MINUTE	MINUTE
Minutes	मिनटें
Minutes Template	मिनट नमूना
Minutes Type	मिनट वर्ग
MINVERSE	MINVERSE
Mirrored	मिररड़
Miscellaneous	मिला जुला
Miscellaneous options	मिला जुला विकल्प
Miscellaneous Symbols	मिला जुला संकेत
Miscellaneous Technical	मिला जुला सांकेतिक
Missing components	अनुपस्थित कॉम्पोनेन्ट्स
Missing Element	अनुपस्थित ऐलिमेन्ट्
Missing server name	अनुपस्थित सर्वर नाम्
MMULT	MMULT
Mo	मो
MOD	MOD
MODE	MODE
Mode	प्रकार
mode	प्रकार
Modern	आधुनिक
Modification Date	बदला की हुयी दिनांक
Modified	बदला किया
Modified on	बदला किया
Modify	सुधारो
Modify cell	कोष्ठ सुधारो
Modify Color Depth	रंग गहराई सुधारो
Modify curve smoothing	वक्र मृदुता सुधारो
Modify Data Range	ड़ॉटा फैलाव सुधारो
Modify default values	अनुपस्थिति मूल्य सुधारो
Modify endnote settings	अंतिम टीका निर्धारण सुधारो
Modify Field	क्षेत्र सुधारो
Modify Field Type	क्षेत्र वर्ग सुधारो
Modify footnote	पृष्ठ के नीचे की टीका सुधारो
Modify footnote options	पृष्ठ के नीचे की टीका के विकल्प सुधारो
Modify installation	प्रतिष्ठापन सुधारो
Modify Layer	परत सुधारो
Modify Layout	अभिन्यास सुधारो
Modify Link	कड़ी सुधारो
Modify Name	नाम् सुधारो
Modify page format	पृष्ठ रचना सुधारो
Modify page margins	पृष्ठ किनारे सुधारो
Modify references	रेफरेन्स सुधारो
Modify Row Height	पंक्ति ऊँचाई सुधारो
Modify section	विभाग सुधारो
Modify Size	परिमाण सुधारो
Modify slide	स्लइड सुधारो
Modify Slide	स्लइड सुधारो
Modify Slide Layout	स्लइड अभिन्यास सुधारो
Modify SQL statement(s)	SQL वाक्य सुधारो
Modify symbol	संकेत सुधारो
Modify table structure	सारणी बनावट सुधारो
Module	मोड्यूल
Module/Dialog	मोड्यूल/डयलॉग
Modules	मोड्यूलें
Monaco	मोनाको
Mongolian	मंगोलियन
Monochrome	मोनोक्रोम
Month	मास
month	मास
MONTH	MONTH
Months	मास
More	अधिक
More Blue	अधिक नीला
More Brightness	अधिक चमक
More Contrast	अधिक भेद बतलाना
More effects	अधिक प्रभाव
More Green	अधिक हरा
More Info	अधिक सूचना
More Red	अधिक लाल
Morphing	मोर्फिंग
Mosaic	मोसाइक
Mosaic, direct	मोसाइक, सीधा
Mouse inside	मौस भीतरी ओर
Mouse leaves object	मौस वस्तु से बाहर
Mouse moved	मौस का स्थान परिवर्तन किया
Mouse outside	मौस बाहरी ओर
Mouse over object	मौस वस्तु के ऊपर
Mouse pointer visible	मौस का सूचक दण्ड दृष्टिगोचर
Mouse positioning	मौस को स्थान में रखना
Mouse pressed	मौस को दबाया
Mouse released	मौस को मुक्त किया
Move	स्थान परिवर्तन करो
Move data series	ड़ॉटा श्रृंखला का स्थान परिवर्तन करो
Move database object	लेखासंचय वस्तु का स्थान परिवर्तन करो
Move Down	नीचे की ओर स्थान परिवर्तन करो
Move down	नीचे की ओर स्थान परिवर्तन करो
Move frame	फ्रेम का स्थान परिवर्तन करो
Move horizontally	समतल प्रकार से स्थान परिवर्तन करो
Move Left	बायाँ ओर स्थान परिवर्तन करो
Move left	बायाँ ओर स्थान परिवर्तन करो
Move outline	बाहरी रूपरेखा का स्थान परिवर्तन करो
Move Page Break	पृष्ठ खण्डन का स्थान परिवर्तन करो
Move paragraphs	परिच्छेदों का स्थान परिवर्तन करो
Move Points	बिन्दुओं का स्थान परिवर्तन करो
Move reference-point	रेफरेन्स-बिन्दु का स्थान परिवर्तन करो
Move Right	दाहिनी ओर स्थान परिवर्तन करो
Move right	दाहिनी ओर स्थान परिवर्तन करो
Move Sheet	शीट् का स्थान परिवर्तन करो
Move Sheets	शीटों का स्थान परिवर्तन करो
Move slide	स्लइड का स्थान परिवर्तन करो
Move slides	स्लइडों का स्थान परिवर्तन करो
Move table	सारणी का स्थान परिवर्तन करो
Move table window	सारणी विन्डो का स्थान परिवर्तन करो
Move Up	ऊपर की ओर स्थान परिवर्तन करो
Move Up	ऊपर की ओर स्थान परिवर्तन करो
Move vertically	लंबरूप प्रकार से स्थान परिवर्तन करो
Move/Copy	स्थान परिवर्तन/प्रतिलिपि
Move/Copy Sheet	शीट् का स्थान परिवर्तन/प्रतिलिपि
Moved entries	स्थान परिवर्तन की हुयी प्रविष्टियाँ
Multiline Input	अनेक रेखाओं का इनपुट्
MultiListBox	बहु सूची बॉक्स
multipart/alternative	अनेक भाग/विकल्प
multipart/digest	अनेक भाग/डैजेस्ट्
multipart/form data	अनेक भाग/फ़ॉर्म ड़ॉटा
multipart/mixed	अनेक भाग/मिश्रित
multipart/parallel	अनेक भाग/समानान्तर
multipart/related	अनेक भाग/सम्बन्धित
Multiple	बहुमुखी
Multiple operations	बहुमुखी कार्य
Multiple Operations	बहुमुखी कार्य
Multiple Quick Search	बहुमुखी शीघ्र खोज
Multiple search	बहुमुखी खोज
MULTIPLE.OPERATIONS	MULTIPLE.OPERATIONS
Multiplies the arguments	आर्गुमेन्ट को गुणा करना
Multiply	गुणा करना
MULTIRANGE	MULTIRANGE
Multiselection	बहुमुखी चुनाव
MultiSelection On	बहुमुखी चुनाव शुरु
MUNIT	MUNIT
MVALUE	MVALUE
My Documents	मेरा लेखपत्र
My documents	मेरा लेखपत्र
My Theme	मेरा विषय
Myanmar	मियान्मार
n_population	एन_जन संख्या
n_sample	एन_नमूना
NA	NA
Nabla	नाब्ला
Name	नाम्
Name already exists	नाम् पहिले से ही अस्तित्व में है
Name double: ($Arg1)	नाम् द्विगुणित: ($Arg1)
Name HTML design	HTML डिसैन् नाम्
Name Object	वस्तु नाम्
Name of Report	रिपोर्ट का नाम्
Name of scenario	विवरण का नाम्
Name of variable	परिवर्ती का नाम
Names	नाम
Namibia	नमीबिया
Naming Conflict	नाम देने में कठिनाई
Native SQL	असली SQL
Natural Logarithm	प्राकृतिक लघुगणकविधि
Natural Numbers Set	प्राकृतिक संख्या समूह
Natural Spline	प्राकृतिक स्प्लैन्
Natural Splines	प्राकृतिक स्प्लैन्स
Navigate	नाविगेट्
Navigation	नाविगेशन्
Navigation bar	नाविगेशन् पट्टी
Navigation Bar Visible	दृष्टिगोचर नाविगेशन् पट्टी
Navigator	नाविगेटर
Navigator On/Off	नाविगेटर शुरु/बंद
Navigator Settings	नाविगेटर निर्धारण
Navigator visible	दृष्टिगोचर नाविगेटर
Negative deviation	निषेधात्मक विचलन
Negative numbers red	निषेधात्मक संख्या लाल
NEGBINOMDIST	NEGBINOMDIST
Nepal	नेपाल
Nepali	नेपाली
Nepali (India)	नेपाली (भारत)
Net	नेट्
Net access	नेट् प्रवेश
Netherlands	नेदर्लान्ड
Netting	नेट्टिंग
Network	नेटवर्क
Network connection	नेटवर्क कनेक्शन्
Network in use	उपयोग में रहनेवाला नेटवर्क
Network Installation	नेटवर्क प्रतिष्ठापन
Network operating system	नेटवर्क ऑपरेटिंग सिस्टम
Network system	नेटवर्क सिस्टम
Never	कभी नहीं
Never execute	कभी नहीं चलाना
Never register	कभी नहीं रजिस्टर करना
Never replace	कभी नहीं प्रतिस्थापित करना
New	नया
New (text only)	नया (केवल टेक्स्ट्)
New content	नया विषय
New data source	नया ड़ॉटा मूल
New Data Source	नया ड़ॉटा मूल
new data_X	नया ड़ॉटा_X
New Database	नया लेखासंचय
New database title	नया लेखासंचय शीर्षक
New design	नया डिसैन
New Dialog	नया डयलॉग
New Dictionary	नया शब्दकोश
New doc.	नया लेखपत्र
New document	नया लेखपत्र
New Document	नया लेखपत्र
New Event	नया घटना
New Folder	नया कोष्ठ
New Folder Bookmark	नया कोष्ठ पृष्ठ संकेत
New form	नया फ़ॉर्म
New Form	नया फ़ॉर्म
New FrameSet	नया फ्रेमसेट्ट
New Gallery	नया गेलरी
New Group	नया समूह
New group	नया समूह
New Image	नया चित्र
New IMAP Account	नया IMAP हिसाब
New LDAP Server	नया LDAP सर्वर
New Library	नया लैब्ररी
New Line	नया रेखा
new line	नया रेखा
New Link	नया कड़ी
New Mail	नया मेइल
New Menu	नया मेनु
New Module	नया मोड्यूल
New name	नया नाम्
New Name	नया नाम्
New News Server	नया समाचार सर्वर
New Outbox	नया ओटबॉक्स
new paragraph	नया परिच्छेद
New Paragraph	नया परिच्छेद
New POP3 Account	नया POP3 हिसाब
New Record	नया अभिलेख
New Relation	नया सम्बन्ध
New Search	नया अन्वेषण
New section	नया विभाग
New sheet	नया शीट्
New Snap Object	नया स्नॉप वस्तु
New task	नया कार्य
New template	नया नमूना
New Template (apply)	नया नमूना (लागू करो)
New text	नया टेक्स्ट्
new text	नया टेक्स्ट्
New Theme	नया विषय
New user	नया उपभोक्ता
New user index	नया उपभोक्ता अनुक्रमणी
New versions	नया आवर्तन
New Window	नया विन्डो
New with template	नया नमूना सहित
New Workplace	नया कार्यस्थान
New Zealand	न्यूज़िलान्ड
new_data_X	नया_ड़ॉटा_X
newer or from	नया अथवा से
newer than	से नया
News	समाचार
News (NNTP) Server	समाचार (NNTP) सर्वर
News server	समाचार सर्वर
Newsgroup	समाचार समूह
Newsgroups	समाचार समूह
next	अगला
Next	अगला
Next bookmark	अगला पृष्ठ संकेत
Next control	अगला नियंत्रण
Next drawing	अगला रेखाचित्र
Next Error	अगला गलती
Next footnote	अगला पृष्ठ के नीचे की टीका
Next heading	अगला शीर्षक
Next index entry	अगला अनुक्रमणी प्रविष्टि
Next link	अगला कड़ी
Next Marker	अगला चिह्नित करनेवाला
Next Message	अगला संदेश
Next Note	अगला टिप्पणी
Next OLE object	अगला OLE वस्तु
Next Page	अगला पृष्ठ
Next page	अगला पृष्ठ
Next picture	अगला चित्र
Next record	अगला अभिलेख
Next Reminder	अगला चेतावनी
Next section	अगला विभाग
Next selection	अगला चुनाव
Next Slide	अगला स्लइड
Next Style	अगला शैली
Next table	अगला सारणी
Next table formula	अगला सारणी सूत्र
Next text frame	अगला टेक्स्ट् फ्रेम
Next Unread Message	अगला बिना पढ़ा हुआ सन्देश
Next Update	अगला अपडेट्
Next Window	अगला विन्डो
Nicaragua	निकरगुवा
Nigeria	नैजीरिया
Ninth Outline Level	नवाँ बाहरी रूपरेखा सतह
NNTP (Internet News)	NNTP (इन्टरनेट् समाचार)
No	नहीं
No action	कोई कार्य नहीं
No Action	कोई कार्य नहीं
No additional information	कोई अधिकतर जानकारी नहीं
No additional properties	कोई अधिकतर विशेषतायें नहीं
no assignment	कोई निर्दिष्ट नहीं
No automatic positioning	कोई स्वचालित स्थान देना नहीं
No border	कोई किनारा नहीं
No break	कोई खण्डन नहीं
No cache for	केलिए कोई कॉश नहीं
No changes	कोई परिवर्तन नहीं
No changes discovered	कोई परिवर्तन नहीं
No Character Style	कोई अक्षर शैली नहीं
No draw object	कोई खींचने का वस्तु नहीं
No Drop Caps	कोई बडे अक्षर हटाने का ऑप्शन् नहीं
No duplication	कोई नकल नहीं
No Effect	कोई प्रभाव नहीं
No Entry	कोई प्रविष्टि नहीं
No Field	कोई क्षेत्र नहीं
No fields specified	कोई निर्दिष्ट क्षेत्र नहीं
No Fill	कोई भरने का ऑप्शन् नहीं
No footer	कोई पृष्ठ के अधोभाग की टीका नहीं
No foreign Copyrights!	कोई विदेशी प्रकाशानाधिकृत नहीं
No Format	कोई रचना नहीं
No formula specified.	कोई सूत्र निर्दिष्ट नहीं किया है ।
No function	कोई फंक्शन् नहीं
No further files	कोई ओर फाइल नहीं
No header	कोई शीर्षक नहीं
No heading	कोई शीर्षक नहीं
No hyphenation	कोई हाइफनेशन नहीं
No Indicators	कोई निदर्शक नहीं
No language set	कोई भाषा समूह नहीं
No logo	कोई संकेत नहीं
No modules accessible.	कोई मोड्यूल प्रवेश्य नहीं
no numbering	कोई संख्या नहीं
No Outline	कोई बाहरी रूपरेखा नहीं
No page break	कोई पृष्ठ खण्डन नहीं
No Page End	कोई पृष्ठ अंत नहीं
No pair kerning	कोई जोड़ा केर्निंग नहीं
No pattern	कोई नमूना नहीं
No primary key	कोई प्रैमरी की नहीं
No Proxy for	केलिए कोई प्रॉक्सी नहीं
No proxy server	कोई प्रॉक्सी सर्वर नहीं
No recipient specified.	कोई प्रतिग्राहक निर्दिष्ट नहीं किया है ।
No references found.	कोई रेफरेन्स नहीं मिला ।
No Regression	कोई रिग्रेशन नहीं
No Restart	कोई पुनःप्रारंभ नहीं
No Shadow	कोई छाया नहीं
No status	कोई वस्तुस्थिति नहीं
No storage	कोई संग्रह नहीं
No strikethrough	कोई स्ट्रैकत्रु नहीं
No Symbol	कोई संकेत नहीं
No toner	कोई टोनर नहीं
No transparency	कोई पारदर्शकता नहीं
No underline	कोई रेखांकित नहीं
No Wrap	कोई लपेटना नहीं
No wrap	कोई लपेटना नहीं
NOM	NOM
NOMINAL	NOMINAL
Nominal Interest	अवास्तविक चाहत
Non convertable character	बदलने अयोग्य अक्षर
Noname	कोई नाम् नहीं
Non-breaking spaces	खण्डन करने अयोग्य अंतर
none	कोई नहीं
None	कोई नहीं
None selected	कोई चुना नहीं
non-existant	अस्तित्व-हीन
Nonexistent file	अस्तित्व हीन फाइल
Nonexistent object	अस्तित्व हीन वस्तु
Nonprinting Characters	छपाई करने अयोग्य अक्षरें
Nonprinting characters	छपाई करने अयोग्य अक्षरें
Normal	सामान्य
Normal position	सामान्य स्थान
Normal with lines	रेखा सहित नार्मल
Normals	नार्मल
NORMDIST	NORMDIST
NORMINV	NORMINV
NORMSDIST	NORMSDIST
NORMSINV	NORMSINV
North	उत्तर
Norway	नोर्वे
Norwegian	नोर्वेयन
Norwegian Bokmal	नोर्वेयन बोक्माल
Norwegian Nynorsk	नोर्वेयन नैनोर्स्क
NOT	NOT
Not applied	लागू नहीं किया
Not available	उपलब्ध नहीं
not between	मध्य में नहीं
Not Blinking	टिमटिमाहट नहीं
Not centered	केन्द्रित नहीं
not empty	खाली नहीं
Not enough memory	मेमरी प्राप्य नहीं
Not enough paper	कागज प्राप्य नहीं
not equal	समान नहीं
Not Equal	समान नहीं
not equal to	के समान नहीं
Not implemented	कार्यान्वित नहीं किया
Not Italic	ढेड़ा नहीं
not like	सदृश नहीं
Not Opaque	धुंधला नहीं
not possible	संभव नहीं
Not received	प्राप्त नहीं
Not register-true	रजिस्टर-सही नहीं
Not Selected;Selected;Not Defined	चुना नहीं;चुना;परिभाषित नहीं
Not Shadowed	छायादार नहीं
Not Subset	सबसेट्ट नहीं
Not Superset	सूपरसेट्ट नहीं
Not Table	सारणी नहीं
Not Transparent	पारदर्शक नहीं
not verified	प्रमाणित नहीं
Not Words Only	केवल शब्द नहीं
Not yet implemented	अभी तक कार्यान्वित नहीं किया
Note	टिप्पणी
Note tags	टिप्पणी लगाना
Notes	टिप्पणी
Notes Background	टिप्पणी
Notes only	केवल टिप्पणी
Notes view	टिप्पणी दृश्य
Notes View	टिप्पणी दृश्य
Nothing selected	कुछ चुना नहीं
Nov	नवम्बर
Novell	नोवल
November	नवम्बर
NOW	NOW
NPER	NPER
NPV	NPV
n-th Root	n-th वर्गमूल
number	संख्या
Number	संख्या
Number entries	संख्या प्रविष्टियाँ
Number format	संख्या की रचना
Number Format	संख्या की रचना
Number format recognition	संख्या की रचना का पहचान
Number Format: Currency	संख्या की रचना: मुद्रा
Number Format: Decimal	संख्या की रचना: दशांश
Number Format: Exponential	संख्या की रचना: ऐक्पोनेश्यल
Number Format: Percent	संख्या की रचना: प्रतिशत
Number Format: Standard	संख्या की रचना: स्टान्डर्ड
Number Format: Time	संख्या की रचना: समय
Number Forms	संख्या फ़ॉर्म
Number of cells	कोष्ठों की संख्या
Number of characters	अक्षरों की संख्या
Number of Characters	अक्षरों की संख्या
Number of colors	रंगों की संख्या
Number of connections	कनेक्शनों की संख्या
Number of copies	प्रतिलिपियों की संख्या
Number of Graphics	सुचित्रों की संख्या
Number of Lines	रेखाओं की संख्या
Number of pages	पृष्ठों की संख्या
Number of Pages	पृष्ठों की संख्या
Number of Paragraphs	परच्छेदों की संख्या
Number of segments	भाग की संख्या
Number of sheets	शीटों की संख्या
Number of steps	स्टेप की संख्या
Number of subfolders	अधीन कोष्ठों की संख्या
Number of Tables	सारणियों की संख्या
Number of Words	शब्दों की संख्या
Number of workstations	कार्यस्थानों की संख्या
Number On/Off	संख्या शुरु/बंद
Number range	संख्या फैलाव
Number range only	केवल संख्या फैलाव
Number range options	संख्या फैलाव विकल्प
Number recognition	संख्या पहचान
number_1	संख्या_1
number_2	संख्या_2
number_x	संख्या_x
number_y	संख्या_y
Numbering	संख्या देना
Numbering / Bullets	संख्या देना / बुल्लेट्स
Numbering alignment	संख्या का पंक्तिकरण
Numbering by chapter	अध्याय के अनुसार संख्या देना
Numbering indents	इन्डेन्ट को संख्या देना
Numbering level	सतह को संख्या देना
Numbering Object Bar	वस्तु पट्टी को संख्या देना
Numbering Off	संख्या देना बंद
numbering off	संख्या देना बंद
numbering on	संख्या देना शुरु
Numbering on/off	संख्या देना शुरु/बंद
Numbering On/Off	संख्या देना शुरु/बंद
Numbering Rules	नियमों को संख्या देना
Numbering Style	संख्या देने का शैली
Numbering Styles	संख्या देने का शैलियाँ
Numbering Symbols	संख्या देने का संकेत
Numbering type	संख्या देना का क्रम
Numbering type	संख्या देने का क्रम
Numbering/Bullets	संख्या देना/बुल्लेट्स
Numbers	संख्या
Numerator	अंश
numeric	संख्या
Numeric Field	संख्या क्षेत्र
Numerical Field	संख्या क्षेत्र
Object	वस्तु
Object already exists	वस्तु पहले से ही अस्तित्व मे है
Object and Camera	वस्तु और कॉमेरा
Object Bar	वस्तु पट्टी
Object Bar On/Off	वस्तु पट्टी शुरु/बंद
Object Catalog	वस्तु सूचीपत्र
Object color	वस्तु रंग
Object Connectors	वस्तु कनेक्टर
Object depth	वस्तु गहराई
Object effects	वस्तु प्रभाव
Object frame	वस्तु फ्रेम्
Object index 1	वस्तु अनुक्रमणी 1
Object index heading	वस्तु अनुक्रमणी शीर्षक
Object Menu	वस्तु मेनु
Object name	वस्तु नाम
Object names	वस्तु नाम
Object not accessible	वस्तु प्रवेश्य नहीं
Object points	वस्तु बिन्दु
Object Properties	वस्तु विशेषतायें
Object required	वस्तु की आवश्यकता
Object rotation mode	वस्तु घुमाव प्रकार
Object selection	वस्तु चुनाव
Object type	वस्तु वर्ग
Object with arrow	वस्तु तीर रेखा
Object with shadow	वस्तु छाया सहित
Object without fill	वस्तु बिना भरा
Object Zoom	वस्तु झूम
Object, printable	वस्तु, छपाई करने योग्य
Object;Objects	वस्तु;वस्तु
Objects	वस्तु
Objects always moveable	वस्तु हमेशा स्थान परिवर्तन करने योग्य
Objects on background	पृष्ठभाग में वस्तु
Objects/graphics	वस्तु/सुचित्र
Oblique italic	तिर्यक ढेड़ा
Obtain New Certificate	नया प्रमाणपत्र प्राप्त करना
Occasion	सन्दर्भ
occurrence	घटना
Oct	अक्तूबर
October	अक्तूबर
ODBC	ODBC
ODD	ODD
of	का
Off	बंद
Office Bar	ऑफीस पट्टी
Offline	ऑफलैन
Offline (transacted)	ऑफलैन (व्यवहार की हुयी)
Offset	ऑफसेट्ट
OFFSET	OFFSET
Offset in days	दिनों में ऑफसेट्ट
Offset in minutes	मिनटों में ऑफसेट्ट
Offset line 1	ऑफसेट्ट रेखा 1
Offset line 2	ऑफसेट्ट रेखा 2
Offset line 3	ऑफसेट्ट रेखा 3
Ogham	ओघम्
OK	ठीक है
Old	पुराना
Old Symbol	पुराना संकेत
Old Symbol Set	पुराना संकेत समूह
Old value	पुराना मूल्य
older or from	पुराना अथवा से
older than	से पुराना
OLE	OLE
OLE Automation Error	OLE स्वचालित गलती
OLE Object	OLE वस्तु
OLE object	OLE वस्तु
OLE objects	OLE वस्तु
On	शुरू
on	में
on all pages	सब पृष्ठों में
on even pages	सम संख्या की पृष्ठों में
on odd pages	विषम संख्या की पृष्ठों में
On request	निवेदन पर
on the line	रेखा में
Once per session	कार्य-काल में एक बार
One Slide	एक स्लइड
One-Time	एक-बार
Online	ऑनलैन
Online Layout	ऑनलैन अभिन्यास
Only outside	केवल बाहरी ओर
Opaque	अपारदर्शक
Open	खोलो
Open / Close	खोलो / बन्द करो
Open as template	नमूने जैसे खोलो
Open Circle	वृत्त को खोलो
Open Circle Vertical	वृत्त को लंबरूप में खोलो
Open Document	लेखपत्र को खोलो
Open documents	लेखपत्रों को खोलो
Open existing presentation	अस्तित्व में रहनेवाला प्रस्तुति को खोलो
Open File	फाइल को खोलो
Open Horizontally	समतल प्रकार से खोलो
Open Message	सन्देश को खोलो
Open object	वस्तु को खोलो
Open Vertically	लंबरूप प्रकार से खोलो
Open windows	विन्डों को खोलो
Open with	के सहित खोलो
opening	खोल रहा है
Opening folder	कोष्ठ को खोल रहा है
Operating systems	ऑपरेटिंग सिस्टम
Operation not implemented	कार्य को कार्यान्वित नहीं किया
Operations	कार्य
Operator	प्रवर्तक
Operator Brackets	प्रवर्तक कोष्ठक
Operators	प्रवर्तक
Optical Character Recognition	ऑप्टिकल अक्षर की पहचान
Optimal	योग्य
Optimal Column Width	योग्य स्तंभ चौड़ाई
Optimal Height	योग्य ऊँचाई
Optimal Page Wrap	योग्य पृष्ठ लपेट
Optimal Row Height	योग्य पंक्ति की ऊँचाई
Optimal Width	योग्य चौड़ाई
Optimal Window Size	योग्य विन्डो परिमाण
Optimal wrap	योग्य लपेट
Optimize	योग्य करना
Optimized	योग्य की हुयी
Optimized output	योग्य की हुयी औटपुट्
Option Bar	विकल्प पट्टी
Option Button	विकल्प बटन
Option Fields	विकल्प क्षेत्र
Optional Components	वैकल्पिक कॉम्पोनेन्ट्स
Optional Gallery Themes	वैकल्पिक गेलरी विषय
Optional hyphens	वैकल्पिक हाइफन्
Optional line break	वैकल्पिक रेखा खण्डन
Options	विकल्प
Options Bar	विकल्प पट्टी
Options bar/Graphics	विकल्प पट्टी/सुचित्र
OR	OR
Or	अथवा
Orange	नारंगी
Order	क्रम
Organization	संस्था
Organize	व्यवस्था करना
Organize fields	क्षेत्रों को व्यवस्था करना
Organizer	व्यवस्थापक
Orientation	अनुस्थापन
Origin	मूल
Original	यथार्थ
Original format	यथार्थ रचना
Original height	यथार्थ ऊँचाई
Original Size	यथार्थ परिमाण
Original size	यथार्थ परिमाण
Original Text	यथार्थ टेक्स्ट्
Original values	यथार्थ मूल्य
Original width	यथार्थ चौड़ाई
Oriya	ओरिया
Orphan control	ओर्फन नियंत्रण
Orphans	ओर्फन
Other	अन्य
Other application	अन्य कार्यक्रम
Other format	अन्य रचना
Other Icon	अन्य अइकॉन
Other OLE Objects	अन्य OLE वस्तु
Other settings	अन्य निर्धारण
Other Unix systems	अन्य Unix सिस्टम्
Others	अन्य
Otherwise_value	अन्यरूप_मूल्य
Our letter dated	अपना पत्र का दिनांक
Our Ref.	अपना रेफरेन्स
Outbox	औटबॉक्स
outer	बाहरी
Outer	बाहरी
Outer frame border	बाहरी फ्रेम किनारा
Outer margin	बाहरी सीमा
Outer page border	बाहरी पृष्ठ किनारा
Outer paragraph border	बाहरी परिच्छेद किनारा
Outer wrap	बाहरी लपेटना
Outgoing mail	बाहरी ओर जानेवाला मेइल
Outline	बाहरी रूपरेखा
Outline Bar	बाहरी रूपरेखा पट्टी
Outline Level	बाहरी रूपरेखा सतह
Outline Numbering	बाहरी रूपरेखा को संख्या देना
Outline symbols	बाहरी रूपरेखा संकेत
Outline Text	बाहरी रूपरेखा टेक्स्ट्
Outline text flow	बाहरी रूपरेखा टेक्स्ट् धारा
Outline Texts	बाहरी रूपरेखा टेक्स्ट्
Outline to Clipboard	क्लिपबोर्ड में बाहरी रूपरेखा
Outline to Presentation	प्रस्तुति में बाहरी रूपरेखा
Outline View	बाहरी रूपरेखा दृश्य
Output	औटपुट्
Output bin full	औटपुट् बिन भरा है
outside	बाहर
Outside only	केवल बाहर
OVER	OVER
Overflow	अधिकता
Overhead sheet	ओवरहेड शीट्
Overlap	ओवरलॉप
Overlapping	ओवरलॉपिंग
Overview	ओवरव्यू
Overwrite	ओवररैट्
Owns	अपनाना
Pack	पैक
Page	पृष्ठ
Page break	पृष्ठ खण्डन
Page Break	पृष्ठ खण्डन
Page Break Mode	पृष्ठ खण्डन प्रकार
Page Break Preview	पृष्ठ खण्डन पूर्वदृश्य
Page breaks	पृष्ठ खण्डन
Page Columns	पृष्ठ स्तंभ
Page Count	पृष्ठ गिनना
Page Description	पृष्ठ विवरण
Page Down	पृष्ठ नीचे की ओर
Page End	पृष्ठ अंत
Page Format	पृष्ठ का रचना
Page Formatting	पृष्ठ का रचना करना
Page height	पृष्ठ ऊँचाई
Page Layout	पृष्ठ अभिन्यास
Page layout	पृष्ठ अभिन्यास
Page Left	पृष्ठ बायाँ ओर
Page margins	पृष्ठ सीमा
Page name	पृष्ठ का नाम
Page no.	पृष्ठ का संख्या
Page number	पृष्ठ का संख्या
Page Number	पृष्ठ का संख्या
Page Numbers	पृष्ठ का संख्या
Page numbers	पृष्ठ का संख्या
Page options	पृष्ठ का विकल्प
Page order	पृष्ठ क्रम
Page position	पृष्ठ का स्थान
Page Preview	पृष्ठ का पूर्वदृश्य
Page Right	पृष्ठ दाहिनी ओर
Page Settings	पृष्ठ निर्धारण
Page settings	पृष्ठ निर्धारण
Page Setup	पृष्ठ सेटप
Page size	पृष्ठ परिमाण
Page Style	पृष्ठ शैली
Page Style: Columns	पृष्ठ शैली: स्तंभ
Page Styles	पृष्ठ शैलियाँ
Page text area	पृष्ठ टेक्स्ट् विस्तीर्ण
Page Up	पृष्ठ ऊपर की ओर
Page width	पृष्ठ चौड़ाई
Page Width	पृष्ठ चौड़ाई
Page Wrap	पृष्ठ लपेटना
Page(s)	पृष्ठ
Pagebreak	पृष्ठ खण्डन
Pager	पेजर
Pages	पृष्ठ
PAGES	PAGES
Pair kerning	जोड़ा केर्निंग
Pair Kerning	जोड़ा केर्निंग
Pakistan	पाकिस्तान
Pale green	पीला हरा
Pale yellow	पीला
Palettes	पटिया
PalmPilot Installation	पॉमपैलट् का प्रतिष्ठापन
PalmPilot Synchronization	पॉमपैलट् का समय में सहमत करना
Panama	पनामा
Paper	कागज
Paper format	कागज का रचना
Paper jam	कागज का भीड लगा हुआ
Paper orientation	कागज अनुस्थापन
Paper problem	कागज समस्या
Paper size	कागज परिमाण
Paper source	कागज मूल
Paper tray	कागज ट्रेए
Papua New Guinea	पपुआ न्यू गइना
Paragraph	परिच्छेद
Paragraph alignment	परिच्छेद पंक्तिकरण
Paragraph area	परिच्छेद विस्तीर्ण
Paragraph Background	परिच्छेद का पृष्ठभाग
Paragraph break	परिच्छेद खण्डन
Paragraph end	परिच्छेद अंत
Paragraph is	परिच्छेद
Paragraph spacing	परिच्छेद का अंतर देना
Paragraph Style	परिच्छेद शैली
Paragraph Styles	परिच्छेद शैलियाँ
Paragraph text area	परिच्छेद टेक्स्ट् विस्तीर्ण
Paragraphs	परिच्छेदों
Paraguay	परगुवे
Parallel	समानान्तर
Parallel wrap	समानान्तर प्रकार से लपेटना
Parallelogram	समानान्तर चतुर्भुज
Parallelograms	समानान्तर चतुर्भुजें
Parameter input	पैरामीटर इनपुट्
Parameters	पैरामीटर
parent level	उच्च सतह
Partial	असम्पूर्ण
Participants	हिस्सेदार
Pass Count	पास गिनती
Password	कूटशब्द
Password (optional)	कूटशब्द (वैकल्पिक)
Password characters	कूटशब्द अक्षरें
Password protected	कूटशब्द रक्षित
Password required	कूटशब्द का आवश्यकता
Paste	छिपकाओ
Paste all	सब छिपकाओ
Paste Clipboard	क्लिपबोर्ड को छिपकाओ
Paste List	सूची छिपकाओ
Paste name	नाम् छिपकाओ
Paste Special	विशेष को छिपकाओ
Path	मार्ग
Path not found	मार्ग नहीं मिला
Path/File access error	मार्ग/फाइल प्रवेश में गलती
Path/File name	मार्ग/फाइल का नाम्
Path/File Name	मार्ग/फाइल का नाम्
Paths	मार्ग
Pattern	नमूना
Pattern color	नमूना रंग
Pattern Field	नमूना क्षेत्र
Pause	रुकावट
Paused	रुका हुआ
PBM Options	PBM विकल्प
PDF file	PDF फाइल
PEARSON	PEARSON
Pen	कलम
Pending deletion	अनिर्णित मिटाव
Pens	कलम
Per chapter	अध्याय द्वारा
Per document	लेखपत्र द्वारा
Per page	पृष्ठ द्वारा
Percent	प्रतिशत
Percent with symbols	संकेतों सहित प्रतिशत
Percentage	प्रतिशत
PERCENTILE	PERCENTILE
PERCENTRANK	PERCENTRANK
Percentual	परसेन्चुवल
Period	समय
Periodic Spline	सामयिक स्प्लैन्
Periodic Splines	सामयिक स्प्लैन्स
Perl	Perl
PERMUT	PERMUT
PERMUTATIONA	PERMUTATIONA
Personal	वैयक्तिक
Personal certificates	वैयक्तिक प्रमाणपत्र
Personal Certificates	वैयक्तिक प्रमाणपत्र
Personal Data	वैयक्तिक ड़ॉटा
Personal letter	वैयक्तिक पत्र
Personal settings	वैयक्तिक निर्धारण
Perspective shadow	दृश्य छाया
Peru	पेरु
PGM Options	PGM विकल्प
Philippines	फिलिपैन्स
Phone Dialer	फोन डयल करनेवाला
Phone/cellphone	फोन/सेलफोन
Phone/Cellphone/Fax	फोन/सेलफोन/फॉक्स
Phonetic Symbols	फोन सम्बन्धी संकेत
Phong	फोन्ग
Photo CD Options	फोटो CD विकल्प
PI	PI
Pica	पिका
PICT Options	PICT विकल्प
Picture Placeholders	चित्र स्थानधारक
Picture placeholders	चित्र स्थानधारक
Pictures	चित्र
Pies	पइस
Pixel editor	पिक्सेल संपादक
Pixel Mode	पिक्सेल प्रकार
Pixel mode	पिक्सेल प्रकार
Pixels	पिक्सेल
Placeholder	स्थानधारक
Placeholder expression	स्थानधारक वर्णन
Placeholders	स्थानधारक
Placement	नियत करना
Plastic	प्लास्टिक
Play	बजाना
Play in full	पूरा बजाना
Play sound	ध्वनि बजाना
Please alter these	कृपया इनको बदलिए
Please choose	कृपया चुनिए
Please comment	कृपया टीका कीजिए
Please prepare	कृपया तैयार कीजिए
Please register now	कृपया अभी रजिस्टर कीजिए
Plug-In	प्लग-ईन
Plug-In Bar	प्लग-ईन पट्टी
Plug-Ins	प्लग-ईन
Plug-Ins Off	प्लग-ईन बंद
plus every	हरेक को बढाओ
PMT	PMT
PNG Options	PNG एन जि विकल्प
Point	बिन्दु
Point reduction	बिन्दु घटाना
Pointed Brackets	बिन्दी कोष्ठक
Pointed Brackets (Scaleable)	बिन्दी कोष्ठक (नापने योग्य)
Pointer	सूचक डन्डा
Points	बिन्दु
POISSON	POISSON
Poland	पोलान्ड
Polish	पोलिश
Polygon	बहुभुज
Polygon, filled	बहुभुज, भरा हुआ
Polygons	बहुभुज
Polyline	पोलीलैन
Polylines	पोलीलैन्स
Pop Art	पोप कला
POP3	POP3
POP3 account	POP3 हिसाब
POP3 Account	POP3 हिसाब
Popup Windows	पोप अप विन्डो
Port	पोर्ट
Port Administration	पोर्ट प्रशासन
Port number	पोर्ट संख्या
Portrait	पोरट्रैट
Portugal	पोर्चुगल
Portuguese	पोर्चुगीस
Portuguese (Brazil)	पोर्चुगीस (ब्रेज़िल)
Portuguese Escudo	पोर्चुगीस इस्कुडो
Position	स्थान
Position and Size	स्थान और परिमाण
Position and spacing	स्थान और अंतर देना
Position in Document	लेखपत्र में स्थान
Position not protected	स्थान रक्षित नहीं
Position options	स्थान का विकल्प
Position protected	स्थान रक्षित
Position X	स्थान X
Position X, complete	स्थान X, सम्पूर्ण
Position Y	स्थान Y
Position Y, complete	स्थान Y, सम्पूर्ण
Positioning of icons	अइकॉनों को स्थान देना
Positions	स्थान
Positive deviation	धनात्मक विचलन
Post	पोस्ट्
Post Document	लेखपत्र पोस्ट् करो
Post Office	ड़ाक घर
Post Office path	ड़ाक घर मार्ग
Post Reply	प्रत्युक्ति पोस्ट् करो
Poster	पोस्टर
Poster colors	पोस्टर रंग
Posterize	पोस्टरैज
Posterize, direct	पोस्टरैज, सीधा
POWER	POWER
Power	पवर
Power regression	पवर रिग्रेशन
Power save mode	संचित करने का पवर प्रकार
PowerPoint Documents	पवरपोइन्ट लेखपत्र
PowerPoint Import	पवरपोइन्ट आयात
PowerPoint templates	पवरपोइन्ट नमूनें
PPM Options	PPM विकल्प
PPMT	PPMT
Precision as shown	शुद्धता दिखाना
Preferred support	अधिक चाहने का समर्थन
Prefix	उपसर्ग
Prefix symbol	उपसर्ग संकेत
Preformatted Text	पहिले से ही रचना की हुयी टेक्स्ट्
Prepare Mail Merge	मेइल मिलाने को तैयार करना
Preparing the installation	प्रतिष्ठापन करने को तैयार करना
Presentation	प्रस्तुति
Presentation Box On/Off	प्रस्तुति बॉक्स शुरु/बंद
Presentation from Abstract	उपसंक्षेप से प्रस्तुति
Presentation Graphic Options	सुचित्र विकल्प का प्रस्तुति
Presentation layout	प्रस्तुति का अभिन्यास
Presentation Object	प्रस्तुति वस्तु
Presentation objects	प्रस्तुति वस्तु
Presentation Options	प्रस्तुति विकल्प
Presentation Settings	प्रस्तुति निर्धारण
Presentation Styles	प्रस्तुति शैलियाँ
Presentation template group	प्रस्तुति नमूने का समूह
Presentation type selection	प्रस्तुति वर्ग का चुनाव
Presets	प्रिसेट्ट
Presiding	प्रिसैडिंग
Preview	पूर्वदृश्य
Preview Mode	पूर्वदृश्य प्रकार
Preview object	पूर्वदृश्य वस्तु
Preview objects	पूर्वदृश्य वस्तु
Preview Zoom	पूर्वदृश्य झूम
Previous bookmark	पिछला पृष्ठसंकेत
Previous contents	पिछला विषय
Previous control	पिछला नियंत्रण
Previous drawing	पिछला रेखाचित्र
Previous Error	पिछला गलती
Previous footnote	पिछला पृष्ठ के नीचे की टीका
Previous heading	पिछला शीर्षक
Previous index entry	पिछला अनुक्रमणी प्रविष्टि
Previous link	पिछला कड़ी
Previous Marker	पिछला मार्कर
Previous Message	पिछला सन्देश
Previous Note	पिछला टिप्पणी
Previous OLE object	पिछला OLE वस्तु
Previous Page	पिछला पृष्ठ
Previous page	पिछला पृष्ठ
Previous picture	पिछला चित्र
Previous Record	पिछला अभिलेख
Previous Reminder	पिछला चेतावनी
Previous section	पिछला विभाग
Previous selection	पिछला चुनाव
Previous Slide	पिछला स्लइड
Previous table	पिछला सारणी
Previous table formula	पिछला सारणी सूत्र
Previous text	पिछला टेक्स्ट्
Previous text frame	पिछला टेक्स्ट् फ्रेम
Previous Unread Message	पिछला बिना पढ़ा हुआ सन्देश
Previous Window	पिछला विन्डो
Primary height	मुख्य ऊँचाई
Primary Key	प्रैमरी की
Primary Y axis	मुख्य Y अक्षरेखा
Print	छपाई
Print black	काला छपाई
Print border	किनारा छपाई करो
Print direction	छपाई दिशा
Print Document	लेखपत्र छपाई
Print File	फाइल छपाई
Print File Directly	फाइल को सीधा छपाई करो
Print form letters	फ़ॉर्म पत्रों को छपाई करो
Print format	छपाई रचना
Print from	से छपाई
Print from bottom	नीचे से छपाई
Print from top	ऊपर से छपाई
Print Layout	छपाई अभिन्यास
Print layout	छपाई अभिन्यास
Print Layout On/Off	छपाई अभिन्यास शुरु/बंद
Print monitor	छपाई उपदेशक
Print Monitor	छपाई उपदेशक
Print options	छपाई विकल्प
Print Options	छपाई विकल्प
Print page view	छपाई पृष्ठ का दृश्य
Print Preview	छपाई का पूर्वदृश्य
Print range	छपाई फैलाव
Print Ranges	छपाई फैलाव
Print to file	फाइल में छपाई करो
Printable	छपाई करने योग्य
Printed	छपाई किया
Printer	मुद्रक
Printer busy	मुद्रक काम में लगा है
Printer Name	मुद्रक नाम्
Printer Options	मुद्रक विकल्प
Printer Setting	मुद्रक निर्धारण
Printer Settings	मुद्रक निर्धारण
Printer Setup	मुद्रक सेटप
Printing	छपाई हो रहा है
Printing selection	छपाई चुनाव
Printing Styles	छपाई शैलियाँ
Printout from	से छपाई
Prior to Reset	पुनः स्थापित करने से पहिले
Priority	प्रधान्य
Private	असार्वजनिक
Private data	असार्वजनिक ड़ॉटा
Private Use Area	असार्वजनिक उपयोग स्थान
PROB	PROB
probability	संभावना
Procedure Step	कार्यप्रणाली स्टेप
Processing	कार्यवाही हो रहा है
PRODUCT	PRODUCT
Product	उत्पाद
Product Information	उत्पाद सूचना
Program	प्रोग्राम्
Program Module	प्रोग्राम् मोड्यूल
Program too large	बहुत बडा प्रोग्राम्
Programs	प्रोग्राम्
Progress	प्रस्थान करो
Project	प्रक्षिप्त करो
Project protocol	प्रोटोकोल प्रक्षिप्त करो
Projection X	प्रक्षेपण X
Projection Y	प्रक्षेपण Y
Promote	बढ़ाना
Promote Chapter	अध्याय को उत्तेजित करो
Promote Level	सतह को उत्तेजित करो
Promote Outline	बाहरी रूपरेखा को उत्तेजित करो
Prompt to save	संचित करने को उत्तेजित करो
PROPER	PROPER
Properties	विशेषतायें
Properties change	विशेषतायें बदलना
Properties of	का विशेषतायें
Property changed	विशेषता बदला हुआ
Property status changed	विशेषता वस्तुस्थिति बदला हुआ
Proportional	परस्पर सादृश्य
Proposed Fields	प्रस्तावित क्षेत्र
Protect	रक्षा करो
Protect Cells	कोष्ठों को रक्षा करो
Protect Document	लेखपत्र को रक्षा करो
Protect sheet	शीट् को रक्षा करो
Protected	रक्षित
Protected object positon	रक्षित वस्तु स्थान
Protected object size	रक्षित वस्तु परिमाण
Protected Sheet	रक्षित शीट्
Protection	रक्षा करना
Protocol	प्रोटोकोल
Protocol selection	प्रोटोकोल चुनाव
Protocols	प्रोटोकोल
Proxy	प्रॉक्सी
Proxy Server	प्रॉक्सी सर्वर
Public	सार्वजनिक
Public holidays	सार्वजनिक छुट्टी
Publication type	प्रकाशन वर्ग
Publisher	प्रकाशित
Publisher address	प्रकाशित का पता
Publishers	प्रकाशित
Puerto Rico	पुएर्टो रिको
Punjabi	पंजाबी
Push Button	दबाने का बटन
PV	PV
Pyramid	शुण्डाकार स्तंभ
Pyramids	शुण्डाकार स्तंभ
Pyramids percent	शुण्डाकार स्तंभ प्रतिशत
Pyramids, deep	शुण्डाकार स्तंभ, गहराई
Pyramids, stacked	शुण्डाकार स्तंभ, स्टॉक की हुयी
Quadratic	वर्गत्मक
Quality	गुण
QUARTILE	QUARTILE
Queries	जानकारी
Query	जानकारी
Query - SQL	जानकारी - SQL
Query design	जानकारी डिसैन
Query name	जानकारी नाम
Query title	जानकारी शीर्षक
Quick Search	शीघ्र खोज
Quickstart	शीघ्र प्रारंभ
Quotation	कहना
Quotations	कहना
Quotient Set	भागाफल समूह
R	R
Radial	किरण
Radial green/black	किरण हरा/काला
Radial red/yellow	किरण लाल/पीला
RADIANS	RADIANS
Radio Button	रेडियो बटन
Radius	त्रिज्या
radix	मूल
Raise/lower by	बढति/उतारो पर
RAM	RAM
RAM Disk	RAM डिस्क
RAND	RAND
Range	फैलाव
range	फैलाव
Range names	फैलाव नाम
Ranges	कतरा
RANK	RANK
Rank_c	हिस्सा_c
RATE	RATE
Re	Re
Read	पढो
Read data	ड़ॉटा पढो
Read Documents	लेखपत्र पढो
Read Error	गलति पढो
Read Messages	संदेशों को पढो
Read only	केवल पढने केलिए
read only	केवल पढने केलिए
Reading BASIC module	BASIC माडूयुल को पढ़ना
Reading Controls	नियंत्रणों को पढ़ना
Reading long names	बडा नामों को पढ़ना
Reading messages	संदेशों को पढ़ना
Reading Slot IDs	स्लाट IDs को पढ़ना
Reading subfolders	अधीन कोष्ठों को पढ़ना
Reading the files	फाइलों को पढ़ना
Read-only	केवल-पढ़ने केलिए
Ready	तैयार
Real Numbers Set	रियल संख्या समूह
Real Part	रियल पार्ट
Recalculate	पुनः गणना करो
Recalculate DataPilot Table	ड़ॉटापैलट सारणी पुनः गणना करो
Recalculate Hard	हार्ड को पुनः गणना करो
Receive	प्राप्त करो
Received	प्राप्त
Receiver	प्रतिग्राहक
Receiving server	प्राप्त करनेवाला सर्वर
Record	अभिलेख
Record marker	अभिलेख मार्कर
Record Number	अभिलेख संख्या
Record number	अभिलेख संख्या
Record Search	अभिलेख खोज
Records	अभिलेख
Records Count	अभिलेख गिनती
Rectangle, rounded	आयत, गोलाकार
Rectangle	आयत
Rectangle Frame Tool	आयत फ्रेम औज़ार
Rectangle Tool	आयत औज़ार
Rectangle, unfilled	आयत, न भरा हुआ
Rectangles	आयतें
Rectangular	आयताकार
Rectangular parallelepiped	आयताकार समानान्तर पइपड्
Rectangular red/white	आयताकार लाल/सफेद
Recycle Bin	रिसैकल बिन्
Red	लाल
Redo	फिर से करो
Redraw	फिर से खींचना
Redraw Chart	चार्ट को फिर खींचना
Reduce Font	फ़ॉन्ट को घटावो
Reduce Points	निशानीयो को घटावो
ref	रेफरेन्स
Reference	रेफरेन्स
Reference edge	रेफरेन्स किनारा
Reference Style	रेफरेन्स शैली
Reference value	रेफरेन्स मूल्य
Referenced Field	रेफरेन्स क्षेत्र
References	रेफरेन्स
Refers to	से सम्बन्धित
Reformat Pages	पृष्ठ फिर फाँर्मट करो
Refresh	नवीकरण
Refresh Data Area	ड़ॉटा क्षेत्र नवीकरण
Refresh Data Import	ड़ॉटा इमबोर्ट नवीकरण
Refresh Range	नवीकरण फैलाव
Refresh range	नवीकरण फैलाव
Refresh Traces	खोज नवीकरण
Register	रिजिस्दर
Register later	फिर रिजिस्दर
Register now	अब रिजिस्दर
Registering the components	कॉम्पोनेन्ट्स को रिजिस्टर कर रहा है
Register-true	रिजिस्टर-सच्चा
Registration	रिजिस्टरी
Registration key	रेजिस्ट्रेसन खि
Registration Key	रेजिस्ट्रेसन खि
Registration No.	रेजिस्ट्रेसन नम.
regression curve	रेग्रेस्सन वत्रक् रेखा
Regression curves	रेग्रेस्सन वत्रक् रेखा
Regular	नियमित
Regular expression	नियमित वर्णन
Regular expressions	नियमित वर्णन
Rehearse Timings	समय पर बयान करों
Reject	अस्वीकार
Reject All	सब अस्वीकार
Reject change	परिवर्तन अस्वीकार
Rejectable modification	अस्वीकार करने योग्य परिवर्तन
Rejected	अस्वीकार किया हूआ
Rel. Font Size	रिल. फॉन्ट परिमाण
Relation	सम्बन्ध
Relational Numbers Set	रिलेशनल संख्या समूह
Relations	सम्बन्धें
Relative	सम्बन्धित
Relative exit legend	सम्बन्धित निर्गम लेजन्ड
Relative exit position	सम्बन्धित निर्गम स्थान
Relative font size	सम्बन्धित फ़ॉन्ट परिमाण
Relative size	सम्बन्धित परिमाण
Relative sizes	सम्बन्धित परिमाण
Relative/Absolute References	सम्बन्धित/निश्चित रेफरेन्स
Relief	सहायता
Relief, direct	सहायता,सिधा
Reload	पुनः लोड करो
Reload Frame	फ्रेम पुनःलोड करो
Remaining space	बचा हुआ जगह
Remaining Time	बचा हुआ समय
Remarks	कहना
Remember password	कूटशब्द याद करो
Remind again later	फिर याद करों
Reminder	याद
Remove	हटाओ
remove	हटाओ
Remove All Traces	सब को हटाओ
Remove all Traces	सब को हटाओ
Remove blank paragraphs	खालि परिच्छेदों हटाओ
Remove Bookmark	पृष्ठसंकेत हटाओ
Remove characters	अक्षरों को हटाओ
Remove Dependent	अवलम्बी हटाओ
Remove Dependents	अवलम्बियों को हटाओ
Remove empty paragraphs	खालि परिच्छेदों हटाओ
Remove Entry	प्रविष्टि को हटाओ
Remove Filter	फिल्टर हटाओ
Remove Filter/Sort	फिल्टर/सोर्ट  हटाओ
Remove index	अनुक्रमणी हटाओ
remove invisible content	अगोचर विषय हटाओ
Remove Noise	आवाज हटाओ
Remove noise	आवाज  हटाओ
Remove Precedent	अग्रगामि हटाओ
Remove user installation(s).	उपभोक्ता का प्रतिष्ठापन हटाओ
Removed	हटाया हुआ
Rename	पुनः नाम दो
Rename AutoFormat	स्वचालित रचना को पुनः नाम दो
Rename Folder Bookmark	कोष्ठ पृष्ठसंकेत को पुनः नाम दो
Rename Layer	परत को पुनः नाम दो
Rename object	वस्तु को पुनः नाम दो
Rename Sheet	शीट् को पुनः नाम दो
Rename Slide	स्लइड पुनः नाम दो
Rename Text Block	टेक्स्ट् ब्लॉक् को पुनः नाम दो
Reorganize	फिर से व्यवस्था करो
Reorganize Chart	चार्ट को फिर से व्यवस्था करो
Reorganize persistent data	आग्रह-युक्त डॉटा को फिर से व्यवस्था करो
Repaginate	रिपेजिनेट
Repagination	रिपेजिनेशन
Repair	मरम्मत करो
Repair installation	प्रतिष्ठापन का मरम्मत करो
repeat	दुहराना
Repeat	दुहराना
Repeat alignment	पंक्तिकरण दुहराना
Repeat column	स्तंभ दुहराना
Repeat header	शीर्षक दुहराना
Repeat heading	शीर्षक दुहराना
Repeat row	पंक्ति दुहराना
Repeat Search	खोज दुहराना
Repeat search	खोज दुहराना
Replace	प्रतिस्थापन
REPLACE	REPLACE
Replace All	सब प्रतिस्थापित करो
Replace all	सब प्रतिस्थापित करो
Replace By	से प्रतिस्थापित
Replace Control	नियंत्रण प्रतिस्थापन
Replace Custom Styles	व्यवस्था शैलियाँ प्रतिस्थापित करो
Replace dashes	डॉशों को प्रतिस्थापित करो
Replace existing libraries	अस्तित्व में रहनेवाला लैब्ररियाँ को प्रतिस्थापित करो
Replace graphics	सुचित्रों को प्रतिस्थापित करो
Replace with	से प्रतिस्थापित करो
Replace with background	पृष्ठभाग सहित प्रतिस्थापित करो
Replacement table	प्रतिस्थापना सारणी
Replacements	प्रतिस्थापना
Reply	प्रत्युक्ति
Reply Path	प्रत्युक्ति मार्ग
Reply to	को प्रत्युक्ति
Reply To	को प्रत्युक्ति
Reply to All	सब को प्रत्युक्ति
Reply to group	समूह को प्रत्युक्ति
Reply to Mail	मेइल को प्रत्युक्ति
Reply to sender	भेजनावाले को प्रत्युक्ति
Report	रिपोर्ट
Report design	रिपोर्ट डिसैन
Report name	रिपोर्ट नाम
Report type	रिपोर्ट वर्ग
Reports	रिपोर्ट
REPT	REPT
Republic of Moldova	रिपब्लिक ऑफ माल्डोवा
Request when opened	निवेदन खोलने के समय
Required	मांगना
Required argument lacking	आवस्य आर्गुमेन्ट मांगना
Required disk space	आवश्यक डिस्क जगह
Research report	अन्वेषण रिपोर्ट
Resend	फिर से भेजो
Reset	पुनः स्थापित करो
Reset attributes	ऐट्रिब्यूट्स पुनः स्थापित करो
Reset Cell	कोष्ठ पुनः स्थापित करो
Reset Default	अनुपस्थिति पुनः स्थापित करो
Reset Font Attributes	फॉन्ट ऐट्रिब्यूट्स पुनः स्थापित करो
Reset Routing	रूटिंग को पुनः स्थापित करो
Reset Scale	स्केल पुनः स्थापित करो
Reset Tip List	टिप सूची पुनः स्थापित करो
Resizable	पुनः परिमाण बदलने योग्य
Resize	पुनः परिमाण दो
Resize frame	फ्रेम को पुनः परिमाण दो
Resize table window	सारणी विन्डो को पुनः परिमाण दो
Resize X, complete	X को पुनः परिमाण दो, सम्पूर्ण
Resize X, single	X को पुनः परिमाण दो, अकेला
Resize Y, complete	Y को पुनः परिमाण दो, सम्पूर्ण
Resize Y, single	Y को पुनः परिमाण दो, अकेला
Resolution	विश्लेषण
Resolution [DPI]	विश्लेषण [DPI]
Resource exhausted	स्रोत निश्शेषित
Responsible	कर्तव्य
Restart	पुनः प्रारंभ
Restart numbering	संख्या देना पुनः प्रारंभ करो
Restart Numbering	संख्या देना पुनः प्रारंभ करो
Restore	पूर्व अवस्था में पहुँचाना
Restore Data Source	ड़ॉटा मूल को पूर्व अवस्था में पहुँचाना
Restore editing view	संपादन दृश्य को पूर्व अवस्था में पहुँचाना
Restore expand state	विस्तृत दिनांक को पूर्व अवस्था में पहुँचाना
Restore View	दृश्य पूर्व अवस्था में पहुँचाना
Restoring components	कॉम्पोनेन्ट्स को पूर्व अवस्था में पहुँचा रहा है
Restrictions	सीमा
Result	प्रभाव
result_vector	प्रभाव_वेक्टर
Results Minutes	नतीजा मिनिटें
Results to	में नतीजा
Resume without error	गलती न फिर आरम्प करो
Retrieve all records	सब अभिलेखों को अन्वेषण से प्राप्त करो
Retry	फिर चलो
Return	लौटना
Return Receipt To	लौटना
Returned with thanks	लौटना
Reverse	उलटना
Reverse Circumflex	उलटा सर्खफ्लेक्स
Reverse columns proportionally	स्तंभों परस्पर उलटा करों
Reversed	उलटा हुआ
RGB	RGB
RGB colors	RGB रंग
RGB Colors	RGB रंग
RGB proportions	RGB समानता
RGB values	RGB मूल्य
Rhombus	विषम कोण समचतुर्भुज
Rhombuses	विषम कोण समचतुर्भुज
Right	दाहिना
right	दाहिना
RIGHT	RIGHT
Right Arc	दाहिना चाप
Right Area	दाहिना क्षेत्र
Right Arrow	दाहिना तीर रेखा
Right border spacing	दाहिना किनारे में अंतर जहा
Right column	दाहिना स्तंभ
Right frame border	दाहिना फ्रेम किनारा
Right guide	दाहिना सहायक
Right Join	दाहिना जोड़
Right limit expected	दाहिना सीमा की प्रतीक्षा
Right margin	दाहिना सीमा
right outside	दाहिना बाहर
Right Page	दाहिना पृष्ठ
Right page border	दाहिना पृष्ठ किनारे
Right pages	दाहिना पृष्ठों
Right paragraph border	दाहिना परिच्छेद किनारे
Right Semicircle	दाहिना अर्धवृत्त
Right wrap	दाहिना लपेटना
Rings	चक्करों
RLE coding	RLE कोडिंग
Roll	घुमना
Roll from Bottom	नीचे से घुमना
Roll from Left	बायाँ से घुमना
Roll from Right	दाहिना से घुमना
Roll from Top	ऊपर से घुमना
Romania	रोमेनिया
Romanian	रोमेनियन
Romansch	रोमेनश
Root	रूट
Root spacing	रूट अंतर दो
Roses	गुलाबियाँ
Rotate	घुमाओ
Rotate 3D object	3D वस्तु घुमाओ
Rotate all	सब घुमाओ
Rotation	घुमाव
Rotation angle	घुमाव कोण
Rotation left	बायाँ ओर घुमाओ
rotation object	घुमाव वस्तु
rotation objects	घुमाव वस्तु
Rotation right	दाहिनी ओर घुमाओ
ROUND	ROUND
Round	गोलाकार
Round Brackets	गोलाकार कोष्ठक
Round Brackets (Scaleable)	गोलाकार कोष्ठक (नापने योग्य)
Round Pen	गोलाकार कलम
ROUNDDOWN	ROUNDDOWN
Rounded edges	गोलाकार किनारें
Rounded large arrow	गोलाकार का बडा तीर रेखा
Rounded Parallelogram	गोलाकार समानान्तर चतुर्भुज
Rounded parallelograms	गोलाकार समानान्तर चतुर्भुजें
Rounded rectangle	गोलाकार आयत
Rounded Rectangle, unfilled	गोलाकार आयत, न भरा हुआ
Rounded Rectangles	गोलाकार आयतें
rounded rhombus	गोलाकार विषम कोण समचतुर्भुज
Rounded rhombuses	गोलाकार विषम कोण समचतुर्भुज
Rounded short arrow	गोलाकार का छोटा तीर रेखा
rounded square	गोलाकार समचतुर्भुज
Rounded Square, unfilled	गोलाकार समचतुर्भुज, न भरा हुआ
Rounded Squares	गोलाकार समचतुर्भुज
ROUNDUP	ROUNDUP
Row	पंक्ति
ROW	ROW
Row Break	पंक्ति खण्डन
Row deleted	पंक्ति मिटाया
Row Height	पंक्ति ऊँचाई
Row height	पंक्ति ऊँचाई
Row input cell	पंक्ति इनपुट कोष्ठ
Row inserted	पंक्ति जोड़ा
Row labels	पंक्ति लेबिलें
Rows	पंक्तियाँ
ROWS	ROWS
Rows to repeat	दुहरानेवाला पंक्तियाँ
RRI	RRI
RSQ	RSQ
RTF	RTF
RTF File	RTF फाइल
Rule applied:	रूल लागू हूआ
Ruler	रूलर
Ruler On/Off	रूलर शुरु/बंद
Rulers	रूलर
Rulers visible	रूलर गोचर
Rules active	क्रियाशील नियम
Run	चलाओ
Run AutoText Entry	स्वचालित टेक्स्ट् प्रविष्टि चलाओ
Run BASIC	BASIC चलाओ
Run DataPilot	ड़ॉटापैलट चलाओ
Run Goal Seek	गोलसीक चलाओ
Run macro	मॉक्रो चलाओ
Run Macro Field	मॉक्रो क्षेत्र चलाओ
Run Query	जानकारी चलाओ
Runic	रूनिक
Russian	रूस्सियन
Russian Federation	रूस्सियन राज्य संध
Sa	एसए
Salmon	सल्मन
Salutation	अभिनंदन
Salvage	बचाना
Same content left/right	समान विषय बायाँ/दाहिना
Same orientation	समान अनुस्थापन
Sans	सान्स
Sanskrit	संस्कृत
Saturation	परिपूर्णता
Saudi Arabia	सौदि अरेबिया
Save	संचित करो
Save All	सब संचित करो
Save and attach	संचित करो और बाँधो
Save As	संचित करो जैसे
Save As Template	नमूने जैसे संचित करो
Save Background	पृष्ठभाग को संचित करो
Save BASIC	BASIC को संचित करो
Save configuration	रूपरेखा को संचित करो
Save Copy as	प्रतिलिपि को संचित करो जैसे
Save current record	वर्तमान अभिलेख को संचित करो
Save Document	लेखपत्र संचित करो
save document	लेखपत्र संचित करो
Save Document As	लेखपत्र को संचित करो जैसे
Save Draft	ड्राफ्ट् संचित करो
Save FrameSet	फ्रेम सेट्ट संचित करो
Save FrameSet As	फ्रेम सेट्ट को संचित करो जैसे
Save graphics	सुचित्रों को संचित करो
Save Graphics	सुचित्रों को संचित करो
Save Keyboard Configuration	कीबोर्ड रूपरेखा को संचित करो
Save Library	लैब्ररी संचित करो
Save locally	स्थानिक प्रकार से संचित करो
Save Locally	स्थानिक प्रकार से संचित करो
Save Menu Configuration	मेनु रूपरेखा संचित करो
Save New Version	नया आवर्तन को संचित करो
Save password	कूटशब्द संचित करो
Save query	जानकारी को संचित करो
Save Record	अभिलेख को संचित करो
save Report	रिपोर्ट को संचित करो
Save Source As	मूल को संचित करो जैसे
Save table design	सारणी डिसैन को संचित करो
Save Text Block	टेक्स्ट् ब्लॉक को संचित करो
Save Toolbar Configuration	औज़ार पट्टी का रूपरेखा को संचित करो
Save transparency	पारदर्शकता संचित करो
Save with password	कूटशब्द सहित संचित करो
Saved by	से संचित की हुयी
Saving document	लेखपत्र बचाना
Saving messages	बचाना खबरों
Scale	नापना
Scale all brackets	नापना सब प्राकेट्स
Scale axes	अक्षरेखों को नापो
Scale Screen Display	परदा प्रदर्शन नापना
Scale Text	नापना टेक्स्ट्
Scaled depth	नापना  गहराई
Scaling	नापना
Scan	स्कॉन
Scan area	स्कॉन क्षेत्र
Scan Request	स्कॉन विनय
Scan Source	स्कॉन मूल
Scanner	स्कॉनर
Scenario	विवरण
Scenario Manager	विवरण प्रबन्धक
Scenario Name	विवरण का नाम
Scenario not found	विवरण नहिं मिला
Scenarios	विवरणों
Scientific	विज्ञानिक्
Screen	आड
Script	स्क्रिप्ट्
Script error	स्क्रिप्ट् गलति
Script type	स्क्रिप्ट् वर्ग
Scripting	स्क्रिप्टिंग
Scroll bar	स्क्रॉल पट्टी
Scroll Horizontal	स्खोरोल समतल प्रकार
Scroll In	स्खोरोल अंदर
Scroll Through	स्खोरोल पर
Sea blue	समुत्र नीला
Search	खोज
Search backward	पीछे की ओर खोज
Search backwards	पीछे की ओर खोज
Search criteria	खोज सिद्धान्त
Search criterion	खोज सिद्धान्त
Search direction	खोज दिशा
Search field	खोज क्षेत्र
Search Folder	खोज कोष्ठ
Search for	को खोज करो
Search for Styles	शैलियों को खोज करो
Search Help	खोज सहायता
Search in	खोज करो
Search in bookmarks	पृष्ठसंकेतों पर खोज करो
Search Key	खोज करने की चाभी
Search Location	खोज करने स्थान
Search root	खोज करने मूल
Search term	खोज करने का विषय
Search vector	खोज वेक्टर
search_criteria	खोज_सिद्धान्त
search_text	खोज_टेक्स्ट्
Searching	खोज हो रहा हैं
SECOND	SECOND
Second Outline Level	दूसरा बाहरी रूपरेखा सतह
Secondary axis	दूसरा अक्षरेखा
Secondary X Axis	दूसरा X अक्षरेखा
Secondary Y Axis	दूसरा Y अक्षरेखा
seconds	मिनटों
Section	भाग
Section limits	भाग सीमा
Section name changed	भाग नाम बदला हुआ
Sections	भाग
Secure	सुरक्षित
Security Proxy	रक्षा प्रॉक्सी
Security settings	रक्षा निर्धारण
Segments	खण्ड
Segments (H/V)	खण्ड (H/V)
Select	चुनो
Select a directory	एक डैरक्टरी चुनो
Select address	पता चुनो
Select All	सब चुनो
Select all	सब चुनो
Select All Sheets	सब शीटों को चुनो
Select an AutoLayout	एक स्वचालित अभिन्यास चुनो
Select AutoText	स्वचालित टेक्स्ट् चुनो
Select button style	बटन शैली चुनो
Select Cell Styles	कोष्ठ शैली चुनो
Select Character Left	बायाँ ओर का अक्षर चुनो
Select Character Right	दाहिनी ओर का अक्षर चुनो
Select color scheme	रंग योजना चुनो
Select Column	स्तंभ चुनो
Select currency cells	मुद्रा कोष्ठों को चुनो
Select Data Area	ड़ॉटा क्षेत्र चुनो
Select Data Source	ड़ॉटा मूल चुनो
Select Database Range	लेखासंचय फैलाव चुनो
Select Directory	डैरक्टरी चुनो
Select directory	डैरक्टरी चुनो
Select Down	नीचे चुनो
Select file	फाइल को चुनो
Select files	फाइलों को चुनो
Select Filter	फिल्टर चुनो
Select font	फॉन्ट् चुनो
Select form	फ़ॉर्म चुनो
Select Graphics	सुचित्रों को चुनो
Select Installation Directory	प्रतिष्ठापन डैरक्टरी चुनो
Select Installation Type	प्रतिष्ठापन वर्ग चुनो
Select Language	भाषा चुनो
Select Left	बायाँ ओर चुनो
Select logo	संकेत चुनो
Select Macro	मॉक्रो चुनो
Select Module	मोड्यूल चुनो
Select outline level	बाहरी रूपरेखा सतह चुनो
Select output medium	अवुटपुट साधन चुनो
Select Page Down	पृष्ठ निचे चुनो
Select Page Left	पृष्ठ बायाँ चुनो
Select Page Up	पृष्ठ ऊपर चुनो
Select Paragraph	परिच्छेद चुनो
Select Path	मार्ग चुनो
Select Paths	मार्ग चुनो
Select Range	फैलाव चुनो
Select Right	दाहिनी ओर चुनो
Select root directory	रूट डैरक्टरी चुनो
Select Row	पंक्ति चुनो
Select Rows	पंक्तियों को चुनो
Select Scenario	विवरण का चुनो
Select Source	मूल चुनो
Select Style	शैली चुनो
Select Table	सारणी चुनो
Select target directory	लक्ष्य डैरक्टरी चुनो
Select title graphics	शीर्षक सुचित्रों को चुनो
Select Tool	औज़ार चुनो
Select Up	ऊपर चुनो
Select Word	शब्द चुनो
Selected fields	चुने हुए क्षेत्र
Selected range	चुने हुए फैलाव
Selected records	चुने हुए अभिलेख
Selected section	चुने हुए भाग
Selected slides	चुने हुए स्लइडस
Selection	चुनाव
Selection List	चुनाव सूची
Selection Mode	चुनाव प्रकार
Selection Size	चुनाव परिमाण
semi bold	आधा मोटा
semi light	आधा हल्का
Semiautomatic	आधा स्वचालित
Semicolon	सेमिखोलन
Semicolons	सेमिखोलन
Send	भेजो
Send again	फिर भेजो
Send as E-mail	E-mail से भेजो
Send Backward	पीछे की ओर भेजो
Send default fax	अनुपस्थिति फॉक्स भेजो
Send Document	लेखपत्र भेजो
Send Mail	मेइल भेजो
Send mail	मेइल भेजो
Send Message	सन्देश भेजो
Send news	समाचार भेजो
Send to Back	पीछे की ओर भेजो
Send To Back	पिछे की ओर भेजो
Send: signed (PGP)	भेजो: चिन्ह  (PGP)
Sender	भेजनेवाला
Sending server (SMTP)	भेजनेवाला सर्वर  (SMTP)
Send-Monitor	भेजो-मोनिटर
sent	भेजा
Sent	भेजा
Sent Messages	भेजा हुआ सन्देश
Sent on	में भेजा
Sep	सितम्बर
Separate text at	टेक्स्ट् को अलग करो जैसे
Separated by	से अलगाया हुआ
Separator	अलगानेवाला
Separator line	अलगानेवाला रेखा
Separator options	अलगानेवाला विकल्प
Separator Width	अलगानेवाला चौड़ाई
September	सितम्बर
Serbian	सेर्बियन
Serbian (Cyrillic)	सेर्बियन (सिरिलिक)
Serbian (Latin)	सेर्बियन (लेटिन)
Series	श्रृंखला
Series name	श्रृंखला नाम
Series type	श्रृंखला नमुना
Serif	सेरिफ्
Server	सर्वर
server	सर्वर
Server administration	सर्वर प्रशासन
Server not available	सर्वर उपलब्ध नहीं है
Server Timeout	सर्वर समय पूरा किया
Server User Installation	सर्वर उपभोक्ता का प्रतिष्ठापन
Service	सेवा
Set	सेट्ट करो
Set 3D illumination	3D चमक को सेट्ट करो
Set as Default	अनुपस्थिति जैसे सेट्ट करो
Set As Default	अनुपस्थिति जैसे सेट्ट करो
Set Bookmark Folder	पृष्ठसंकेत कोष्ठ को सेट्ट करो
Set Colors	रंगों सेट्ट करो
Set cursor	कर्सर सेट्ट करो
Set default	अनुपस्थिति सेट्ट करो
Set Default Template	अनुपस्थिति नमूने को सेट्ट करो
Set defaults	अनुपस्थिति सेट्ट करो
Set Image URL	चित्र URL सेट्ट करो
Set Input Mode	इनपुट प्रकार को सेट्ट करो
Set Line Numbering	रेखा को संख्या देना सेट्ट करो
Set Null	नल सेट्ट करो
Set Operations	कार्य सेट्ट करो
Set owner	अधिकारी सेट्ट करो
Set ownership	अधिकार सेट्ट करो
Set Page Number	पृष्ठ संख्या सेट्ट करो
Set page variable	पृष्ठ परिवर्ती को सेट्ट करो
Set Reference	रेफरेन्स सेट्ट करो
Set Reminder	याद दिलानेवाले को सेट्ट करो
Set Root	रूट सेट्ट करो
Set tab order	टेब क्रम सेट्ट करो
Set variable	परिवर्ती को सेट्ट करो
Set-Operations	सेट-कार्य
Setting	निर्धारण
Settings	निर्धारण
Setup	सेटप
Setup Server	सेटप सर्वर
Setup Web Application	सेटप वेब कार्यक्रम
Seventh Outline Level	बाहरी रूपरेखा सतह
SGML	SGML
Shading	छाया हो रहा है
Shadow	छाया
Shadow attributes	छाया ऐट्रिब्यूट्स
Shadow bottom left	छाया नीचे बायाँ
Shadow bottom right	छाया नीचे दाहिना
Shadow color	छाया रंग
Shadow spacing X	छाया अंतर देना X
Shadow spacing Y	छाया अंतर देना Y
Shadow style	छाया शैली
Shadow top left	छाया ऊपर बायाँ
Shadow top right	छाया ऊपर दाहिना
Shadow transparency	छाया पारदर्शकता
Shadow	छाया
Shadowing	छाया
Shape	रूप
Shapes	रूप
Sharpen	तेज होना
Sharpness	तेज
Shear angle	शियर कोण
Shear horizontal, complete	शियर समतल प्रकार, सम्पूर्ण
Shear vertical, complete	शियर लंबरूप प्रकार, सम्पूर्ण
Sheet	शीट्
SHEET	SHEET
Sheet Area	शीट् क्षेत्र
Sheet deleted	शीट् मिटाया हुआ
Sheet Header	शीट् शीर्षक
Sheet inserted	शीट् जोड़ा
Sheet tabs	शीट् टॉब्स
Sheets	शीट्
Shell	शेल
Shift	स्थान बदलो
Shift cells	कोष्ठों का स्थान बदलो
Shift cells down	कोष्ठों का स्थान नीचे की ओर बदलो
Shift cells left	कोष्ठों का स्थान बायाँ ओर बदलो
Shift cells right	कोष्ठों का स्थान दाहिनी ओर बदलो
Shift cells up	कोष्ठों का स्थान ऊपर की ओर बदलो
Shift down	निचे की ओर स्थान बदलो
Shift numbering	गिनना बदलो
Shift right	दाहिनी ओर स्थान बदलो
Short name	छोटा नाम्
Shortcut	सरल विधि
Show	दिखाओ
Show accepted changes	स्वीकृत परिवर्तनों दिखाओ
Show additional information	अधिकतर सूचना दिखाओ
Show Address Book	पता पुस्तक दिखाओ
Show advanced options	उच्च विकल्प दिखाओ
Show All	सब दिखाओ
Show All Fields	सब क्षेत्रों को दिखाओ
Show all windows	सब विन्डोस दिखाओ
Show as tip	सुझाव जैसे दिखाओ
Show Century	शातमान दिखाओ
Show Changes	परिवर्तनों को दिखाओ
Show Column	स्तंभ दिखाओ
Show Columns	स्तंभों को दिखाओ
Show columns	स्तंभों को दिखाओ
Show Details	विवरणों को दिखाओ
Show Draw Functions	खींचने का फंक्शन्स दिखाओ
Show drop caps	बडे अक्षरों को हटाकर दिखाओ
Show extensions	विस्तार दिखाओ
Show file extensions	फाइल विस्तारों को दिखाओ
Show footer	पृष्ठ की नीचे की टीका दिखाओ
Show Form Dialog	फ़ॉर्म डयलॉग दिखाओ
Show front/back	सामने/पीछे दिखाओ
Show groups	समूह दिखाओ
Show Hidden Controls	छिपाया हुआ नियंत्रण दिखाओ
Show HTML Source	HTML मूल दिखाओ
Show invisible files	अगोचर फाइलों को दिखाओ
Show label text	लेबिल टेक्स्ट् दिखाओ
Show labels	लेबिलों को दिखाओ
Show Large Symbols	बडा संकेतों को दिखाओ
Show logo	संकेत दिखाओ
Show maximum	अधिकतम दिखाओ
Show meas. units	मेस.यूनिट्स दिखाओ
Show messages	सन्देशों को दिखाओ
Show Newsgroups	समाचार समूहों को दिखाओ
Show Note	टिप्पणी दिखाओ
Show notes	टिप्पणियों को दिखाओ
Show numbering	संख्या देना दिखाओ
Show page variable	पृष्ठ परिवर्ती दिखाओ
Show preview	पूर्वदृश्य दिखाओ
Show rejected changes	अस्वीकार की हुयी परिवर्तनों को दिखाओ
Show Row	पंक्ति दिखाओ
Show Sheet	शीट् दिखाओ
Show Snap Lines	तडक रेखों को दिखाओ
Show sublevels	अधीनस्तरों को दिखाओ
Show subpoints	अधीनविषयों दिखाओ
Show symbol	संकेत दिखाओ
show table	सारणी दिखाओ
Show Tips	सुझावों को दिखाओ
Show value	मूल्य दिखाओ
Show variable	परिवर्ती दिखाओ
Show/Hide Axis Description(s)	अक्षरेखा विवरण दिखाओ/छिपाओ
Show/Hide Hyperlink Bar	हाइपरलिंक पट्टी दिखाओ/छिपाओ
Show/Hide	दिखाओ/छिपाओ
Show/Hide Status Bar	वस्तुस्थिति पट्टी दिखाओ/छिपाओ
Shutdown	शटडौन्
Shutdown Port	शटडौन् पोर्ट
Shutdown web server	शटडौन् वेब सर्वर
sigma	सिग्मा
SIGN	SIGN
Signature	हस्ताक्षर
Significance	आवश्यक
Similarity search	सादृश्य खोज
Similarity Search	सादृश्य खोज
Simple	सामान्य
Simple control points	सामान्य नियंत्रण बिन्दु
SIN	SIN
since	से
since saving	से बचत
Sindhi	सिन्धी
Sine	ज्या
Singapore	सिन्गपूर
Single	अकेला
Single field	अकेला क्षेत्र
Single height	अकेला ऊँचाई
Single horizontal shear	अकेला समतल प्रकार शियर
Single label	अकेला लेबिलों
Single letter	अकेला अक्षर
Single line	अकेला रेखा
Single Line Spacing	अकेला
Single Lines	अकेला रेखाएँ
single Lines (Scaleable)	अकेला रेखाएँ
Single position X	अकेला स्थान X
Single position Y	अकेला स्थान Y
Single print jobs	अकेला छपाई कार्य
Single quotes	अकेला क्वोट्स
Single rotation	अकेला घुमाव
Single rotation angle	अकेला घुमाव कोण
Single shear angle	अकेला शियर कोण
Single Step	अकेला स्टेप
Single Stepping	अकेला स्टेप्पिंग
Single strikethrough	अकेला स्ट्रैकत्रु
Single underline	अकेला रेखांकित
Single vertical shear	अकेला लंबरूप प्रकार शियर
Single width	अकेला चौड़ाई
Single, bold	अकेला, मोटा
Single, fine lines	अकेला, उत्तम रेखाएँ
Single, thick	अकेला, घना
Single, thin	अकेला, पतला
Single, very thick	अकेला, अधिक घना
SINH	SINH
Sinhala	सिंहला
Site Certificate	सैट प्रमाणपत्र
Site certificates	सैट प्रमाणपत्र
Site Certificates	सैट प्रमाणपत्र
Six Slides	छे स्लइडस
Sixth Outline Level	छठवाँ बाहरी रूपरेखा सतह
Size	परिमाण
Size (MB)	परिमाण (MB)
Size limitation	परिमाण सीमा
Size not protected	परिमाण रक्षित नहीं
Size protected	परिमाण रक्षित
Size Protection	परिमाण रक्षा
Size to grid	परिमाण जाल तक
SKEW	SKEW
Skip empty cells	खाली कोष्ठों को त्यागना
Sky	आकाश
Slant	तिरछा
Slant Horizontal	तिरछा समतल प्रकार
Slant Vertical	तिरछा लंबरूप प्रकार
Slide	स्लइड
Slide / Object	स्लइड/वस्तु
Slide Background	स्लइड पृष्ठभाग
Slide Bar	स्लइड पट्टी
Slide Design	स्लइड डिसैन
Slide Effects	स्लइड प्रभाव
Slide Mode	स्लइड प्रकार
Slide Object Bar	स्लइड वस्तु पट्टी
Slide parameter	स्लइडों पैरामीटर
Slide Show	स्लइड दिखाओ
Slide Transition	स्लइड परिवर्तन
Slide view	स्लइड दृश्य
Slide View	स्लइड दृश्य
Slide view time	स्लइड दृश्य समय
Slide/Level	स्लइड/सतह
slides	स्लइडस
Slides Per Row	स्लइडस एक पंक्ति पर
Slides View	स्लइडों का दृश्य
SlideTransition	स्लइडों परिवर्तन
SLN	SLN
Slogan	स्लोगन
SLOPE	SLOPE
Slot IDs	स्लॉट IDs
Slot/Control unknown :"($Arg1)"	स्लाट/नियंत्रण अज्ञात :"($Arg1)"
Slots	स्लाटस
Slovakia	स्लोवेकिया
Slovakian	स्लोवेकियन
Slovenia	स्लोवेनिया
Slovenian	स्लोवेनियन
Slow	मन्द
SMALL	SMALL
Small arrow	छोटा तीर रेखा
Small Capitals	छोटा बडा अक्षर
Small caps	छोटा  बडे अक्ष
Small Form Variants	छोटा फ़ॉर्म वेरिऐन्ट्स
Small Gap	छोटा अंतर
Small Icons	छोटा अइकॉनें
Smallest	बहुत छोटा
Smart	स्मार्ट
Smooth	मृदु
Smooth scroll	मृदु स्क्रॉल
Smooth Transition	मृदु परिवर्तन
Smooth, direct	मृदु, सीधा
SMTP (Internet Mail)	SMTP (इन्टरनेट् मयिल)
Snap	स्नॉप
Snap grid	स्नॉप जाल
Snap Line/Point	स्नॉप रेखा/बिन्दु
Snap lines	स्नॉप रेखाएँ
Snap Lines Visible	स्नॉप रेखाएँ गोचर
Snap position	स्नॉप स्थान
Snap range	स्नॉप फैलाव
Snap to	में स्नॉप
Snap to Grid	जाल में स्नॉप
Snap to grid	जाल में स्नॉप
Snap To/Snap Position	में स्नॉप /स्नॉप स्थान
Socks Proxy	सोक्स प्राख्सि
Software License Agreement	साँफटवेयर लैसन्स स्वीकारपत्र
Solarization	सोलरैसेशन
Solarization, direct	सोलरैसेशन, सिधा
Solid	ठोस
Sort	सोर्ट
Sort Ascending	आरोहण क्रम में सोर्ट करो
Sort by	से सोर्ट करो
Sort by Columns	स्तंभों से सोर्ट करो
Sort by Rows	पंक्तियों से सोर्ट करो
Sort Columns	स्तंभों को सोर्ट करो
Sort Criteria	सोर्ट सिद्धान्त
Sort criteria	सोर्ट सिद्धान्त
Sort Data	ड़ॉटा सोर्ट करो
Sort Descending	अवरोहण क्रम में सोर्ट करो
Sort keys	सोर्ट की
Sort Lists	सूचियाँ सोर्ट करो
sort order	सोर्ट क्रम
Sort order	सोर्ट क्रम
Sort Rows	पंक्तियों को सोर्ट करो
Sort table	सारणी सोर्ट करो
Sort text	टेक्स्ट् सोर्ट करो
sorted	सोर्ट की हुयी
Sorting	सोर्ट करना
sorting	सोर्ट करना
Sound	शब्द
Sound Files	ध्वनि फाइलें
Sounds	शब्द
Source	मूल
Source Code	मूल कोड
Source color	मूल रंग
Source data area	मूल ड़ॉटा क्षेत्र
Source Directory	मूल डैरक्टरी
Source Document	मूल लेखपत्र
Source file	मूल फाइल
Source not specified	मूल निर्दिष्ट नहीं किया
Source picture	मूल चित्र
Source Text	मूल टेक्स्ट्
Source/Target	मूल/लक्ष्य
South	दक्षिण
South Africa	दक्षिण आफ्रिका
South Korea	दक्षिण कोरिया
Space	अंतर
space bar	अंतरपट्टी
Space Columns Equally	स्तंभों को समान अंतर में रखो
Space Equally	समान अंतर में रखो
Space to Text	टेक्स्ट् के बीच अंतर
Spaces	अंतर
Spacing	अंतर देना
Spacing disabled	अंतर देना सक्षम नहीं किया
Spacing enabled	अंतर देना सक्षम किया
Spacing Modifier Letters	सुधार अक्षरों को अंतर देना
Spacing to borders	किनारों को अंतर देना
Spacing to contents	विषयों को अंतर देना
Spacing to text	टेक्स्ट् को अंतर देना
Spain	स्पेइन्
Spanish	स्पेनिश
Spanish (Argentina)	स्पेनिश  (अर्जेन्टैना)
Spanish (Bolivia)	स्पेनिश  (बोलिविया)
Spanish (Chile)	स्पेनिश  (चिलि)
Spanish (Columbia)	स्पेनिश  (कोलम्बिया)
Spanish (Costa Rica)	स्पेनिश  (कोस्टा रिका)
Spanish (Dom.)	स्पेनिश  (डोम.)
Spanish (El Salvador)	स्पेनिश  (एल सल्वडोर)
Spanish (Equador)	स्पेनिश  (इक्वडार)
Spanish (Guatemala)	स्पेनिश  (गटमाला)
Spanish (Honduras)	स्पेनिश  (होन्डुरस)
Spanish (Mexico)	स्पेनिश  (मेक्सिको)
Spanish (Modern)	स्पेनिश  (माडर्न)
Spanish (Nicaragua)	स्पेनिश  (निकरगुवा)
Spanish (Panama)	स्पेनिश  (पनामा)
Spanish (Paraguay)	स्पेनिश  (परगुवे)
Spanish (Peru)	स्पेनिश  (पेरु)
Spanish (Puerto Rico)	स्पेनिश  (पुर्टो रिको)
Spanish (Uruguay)	स्पेनिश  (उरुगुवे)
Spanish (Venezuala)	स्पेनिश  (वेनेझुवेला)
Spanish Peseta	स्पेनिश पेसेटा
Speaker	सभापति
Special	विशेष
Special Character	विशेष अक्षर
Special Characters	विशेष अक्षरें
Special Functions	विशेष फंक्शन्स
Special Styles	विशेष शैलियाँ
Specialized	विशिष्ट
Specials	विशेष
Specify user name	उपभोक्ता नाम निर्दिष्ट करो
Specular	स्पेक्युलर
Speech recognizer	वचन पहचान करनेवाला
Speed	गति
Speed of ticker	घड़ी की गति
Spellcheck	अक्षर की जाँच
Spellcheck not available	अक्षर की जाँच उपलब्ध नहीं है
Spelling Options	स्पेल्लिंग विकल्प
sphere	गोला
Sphere	गोला
spheres	गोला
Spin Button	स्पिन बटन
Spiral	चक्राकार
Spiral Inward Left	चक्राकार अन्दर बायाँ
Spiral Inward Right	चक्राकार अन्दर दाहिना
Spiral Outward Left	चक्राकार बाहर बायाँ
Spiral Outward Right	चक्राकार बाहर दाहिना
Split	अलगाना
Split 3D object	3D वस्तु अलगाना
Split Cells	कोष्ठों को अलगाना
Split curve	वक्र रेखा अलगाना
Split Curve	वक्र रेखा अलगाना
Split Frame Horizontally	फ्रेम को समतल प्रकार से अलगाना
Split Frame Vertically	फ्रेम को लंबरूप प्रकार से अलगाना
Split FrameSet Horizontally	फ्रेमसेट्ट को समतल प्रकार से अलगाना
Split FrameSet Vertically	फ्रेमसेट्ट को लंबरूप प्रकार से अलगाना
Split Horizontally	समतल प्रकार से अलगाना
Split Paragraph	परिच्छेद अलगाना
Split Table	सारणी अलगाना
Split table	सारणी अलगाना
Split Vertically	लम्ब प्रकार से अलगाना
Split Window	विन्डो अलगाना
Spreadsheet	स्प्रेडशीट्
Spreadsheet Object Bar	स्प्रेडशीट् वस्तु पट्टी
Spreadsheet Options	स्प्रेडशीट् विकल्प
SQL	SQL
Sql	Sql
Sql [Native]	Sql [असली]
SQL mode	SQL प्रकार
SQL Status	SQL वस्तुस्थिति
SQL syntax error	SQL सिन्टाक्स गलती
SQRT	SQRT
Square	समचतुर्भुज
Square Brackets	समचतुर्भुज कोष्ठक
Square brackets (scalable)	समचतुर्भुज कोष्ठक (स्केल करने योग्य)
Square Pen	समचतुर्भुज कलम
Square Root	वर्ग मूल
Square yellow/white	समचतुर्भुज पीला/सफेद
Square, unfilled	समचतुर्भुज, न भरा हुआ
Squares	समचतुर्भुज
Sri Lanka	श्रीलंका
Stacked	स्टाक किया हूआ
Stacked with symbols	संकेत सहित स्टाक की हुयी
Stagger even	सम स्टेग्गर
Stagger odd	विषम स्टेग्गर
Standard	स्टान्डर्ड
Standard (long)	स्टान्डर्ड (बडा)
Standard (short)	स्टान्डर्ड (छोटा)
Standard Browser	स्टान्डर्ड ब्रउज़र
Standard colors	स्टान्डर्ड रंग
Standard Connector	स्टान्डर्ड कनेक्टर
Standard deviation	स्टान्डर्ड विचलन
Standard Filter	स्टान्डर्ड फिल्टर
Standard HTML format	स्टान्डर्ड HTML रचना
Standard Installation	स्टान्डर्ड प्रतिष्ठापन
Standard Installation (local)	स्टान्डर्ड प्रतिष्ठापन (स्थानिक)
Standard Text Attributes	स्टान्डर्ड टेक्स्ट् ऐट्रिब्यूट्स
Standard Workstation Installation	स्टान्डर्ड कार्यस्थान प्रतिष्ठापन
STANDARDIZE	STANDARDIZE
Star Channels	Star Channels
StarBasic	StarBasic
StarBasic: Find Text	StarBasic: अन्वेषण टेक्स्ट्
StarBasic: Load File	StarBasic: फाइल को लोड करो
StarBasic: Print File	StarBasic: छपाई फाइल
StarBasic: Replace Text	StarBasic: प्रतिस्थापना टेक्स्ट्
StarBasic: Save File	StarBasic: फाइल को संचित करो
StarChannel	StarChannel
StarChannels	StarChannels
Start	प्रारंभ
Start administration service	प्रशासन सेवा प्रारंभ करो
Start angle	प्रारंभ कोण
Start Application	कार्यक्रम प्रारंभ करो
Start at	में प्रारंभ करो
Start automatically	स्वचालित प्रकार से प्रारंभ करो
Start Copying	प्रतिलिपि बनाना प्रारंभ करो
Start daemons	डेमेन्स प्रारंभ करो
Start daemons now	डेमेन्स अभी प्रारंभ करो
Start directory	डैरक्टरी प्रारंभ करो
Start Fill Mode	भरने का प्रकार प्रारंभ करो
Start Image Editor	चित्र संपादक प्रारंभ करो
Start inside	भीतरी ओर प्रारंभ करो
Start Menu	प्रारंभ मेनु
Start numbering at	से संख्या देना प्रारंभ करो
Start object action	वस्तु कार्य प्रारंभ करो
Start presentation	प्रस्तुति प्रारंभ करो
Start quote	क्वोट् प्रारंभ करो
Start Scan	स्कॉन प्रारंभ करो
Start Slide Show	स्लइड दिखाना प्रारंभ करो
Start value	प्रारंभ मूल्य
Start with	सहित प्रारंभ
Start with AutoPilots	ओटोपैलट्स से प्रारंभ करो
StarTestTool	StarTestTool
Starting application	कार्यक्रम प्रारंभ करना
Starting daemons	डेमन्स प्रारंभ करना
State	राज्य
State/Zip/Country	राज्य/Zip/देश
Statistical	अंकशास्त्र
Statistical Functions	अंकशास्त्र फंक्शन्स
Statistics	आँकडे
stats	स्टेट्स
Status	वस्तुस्थिति
Status bar	वस्तुस्थिति पट्टी
Status Bar	वस्तुस्थिति पट्टी
Status Expanded Selection	वस्तुस्थिति विस्तृत चुनाव
STD	STD
StDev	StDev
STDEV	STDEV
StDev (Sample)	StDev (नमूना)
STDEVA	STDEVA
STDEVP	STDEVP
StDevP (Population)	StDevP (जनसंख्या)
STDEVPA	STDEVPA
Step Back	स्टेप पीछे
Step Into	स्टेप पर
Step Out	स्टेप बाहर
Step Over	स्टेप पूरा
Steps	स्टेप्स
STEYX	STEYX
Stock Chart	स्टाक चार्ट
Stock Chart 1	स्टाक चार्ट 1
Stock Chart 2	स्टाक चार्ट 2
Stock Chart 3	स्टाक चार्ट 3
Stock Chart 4	स्टाक चार्ट 4
Stone	पत्थर
Stop	रोको
Stop after	बाद में रोको
Stop attribute	ऐट्रिब्यूट रोको
Stop Browse	ब्रउज़ करना रोको
Stop Macro	मॉक्रो रोको
Storage options	संग्रह विकल्प
Straight Connector	सीधा कनेक्टर
Straight Line	सीधा रेखा
Street	सड़क
Stretch	विस्तार
Stretch from Bottom	निचे से विस्तार करो
Stretch from Left	बायाँ से विस्तार करो
Stretch from Right	दाहिना से विस्तार करो
Stretch from Top	ऊपर से विस्तार करो
Stretched	विस्तार की हुयी
Strict format	कडा रचना
Strike through	स्ट्रैक त्रु
Strikethrough	स्ट्रैकत्रु
Strings	अक्षर समुह
Strong Emphasis	दृढ़ असर
Structure	बनावट
Style	शैली
STYLE	STYLE
Style Catalog	शैली सूचीपत्र
Style name	शैली नाम
Styles	शैलियाँ
Styles in	में शैलियाँ
Stylist	स्टैलिस्ट्
Stylist On/Off	स्टैलिस्ट् शुरु/बंद
Su	सू
Sub	विषय
Subdirectories	अधीन डैरक्टरियाँ
Subdivision	अधीन भाग
Subfields	अधीन क्षेत्र
Subject	विषय
Subject line	विषय वाक्य
Submission encoding	अधिनता ऐनकोडिंग
Subordinate Ini File	सबोर्डिनेट् Ini फाइल
Subpoints per level	अधीन बिन्दु एक सतह में
Subscribe	स्वीकार करो
Subscribed	स्वीकार की हुयी
Subscribed Folders	स्वीकार की हुयी कोष्ठ
Subscribed groups	स्वीकार की हुयी समूह
Subscript	सबस्क्रिप्ट्
Subscript Bottom	सबस्क्रिप्ट् नीचे
Subscript Left	स्क्रिप्टिं बायाँ
Subscript Right	सबस्क्रिप्ट् दाहिना
Subscriptions	स्वीकार करना
Subset	अधीन सेट्ट
SUBSTITUTE	SUBSTITUTE
substituted	प्रतिस्थानिक की हुयी
Substructure	सप बनावट
Subtitle	अधीन शीर्षक
SUBTOTAL	SUBTOTAL
Subtotals	आधा कुलजोड़
Subtract	घटाना
Successful transfer	सफल स्थानान्तर
Suffix	प्रत्यय
Suggestions	सुझावें
Sum	जोड़
SUM	SUM
sum_range	जोड़_फैलाव
SUMIF	SUMIF
Summary	सारांश
Summary Slide	सारांश स्लइड
SUMPRODUCT	SUMPRODUCT
SUMSQ	SUMSQ
SUMX2MY2	SUMX2MY2
SUMX2PY2	SUMX2PY2
SUMXMY2	SUMXMY2
Sun	Sun
Sun/NeXT Audio	Sun/NeXT Audio
Super	सूपर
Superscript	सूपरस्क्रिप्ट्
Superscript Left	सूपरस्क्रिप्ट् बायाँ
Superscript Right	सूपरस्क्रिप्ट् दाहिना
Superscript Top	सूपरस्क्रिप्ट् ऊपर
Superscript/subscript	सूपरस्क्रिप्ट्/सबस्क्रिप्ट्
Superscripts And Subscripts	सूपरस्क्रिप्ट्स और सबस्क्रिप्ट्स
Superset	सूपरसेट्ट
Support medium	सहारा साधन
Supported functions	सहारा फंक्शन्स
Suppress version columns	आवर्तन स्तंभों को दबाओ
Surface angle	तल कोन
Surfaces	तलों
SvDraw Autoshape Adjustment	SvDraw स्वचालित आकार का व्यवस्था
Swahili	स्वाहिलि
Swaziland	स्वाझिलॉन्ड
Sweden	स्वीडन
Swedish	स्वीडिश
Swedish (Finland)	स्वीडिश (फिनलॉन्ड)
Switch Columns	स्तंभों में स्विच करो
Switch on Review	विवरण में स्विच करो
Switch Rows	पंक्तियों में स्विच करो
Switzerland	स्विज़र्लान्ड
SYD	SYD
Symbol	संकेत
Symbol Catalog	संकेत सूचीपत्र
Symbol expected	संकेत प्रतीक्षा
Symbol files (*.sms)	संकेत फाइलें (*.sms)
Symbol Selection	संकेत चुनाव
Symbol Set	संकेत समूह
Symbol Table	संकेत सारणी
Symbols	संकेत
Symbols Only	केवल संकेत
Symmetric	समान
Symmetric arrow	समान तीर रेखा
Symmetric Transition	समान परिवर्तन
Synchronization Complete	समीकरण सम्पूर्ण
Synchronize	समीकरण
Synchronize axes	अक्षरेखाओं का समीकरण
Synchronize contents	समीकरण सन्तोष
Synchronize ends	समीकरण अंत
Synchronize Labels	समीकरण लेबिलों
Synchronize to	समीकरण से
Synchronizing folder	समीकरण कोष्ठ
Synonym	पर्याय
Syntax error	सिन्टक्स गलती
Syriac	शिरियक
SYSDEVSPACE	SYSDEVSPACE
System	सिस्टम
System database	सिस्टम लेखासंचय
System DB	सिस्टम DB
System file	सिस्टम फाइल
System folder	सिस्टम कोष्ठ
System object	सिस्टम वस्तु
System Options	सिस्टम विकल्प
System properties	सिस्टम विशेषतायें
System sound	सिस्टम ध्वनी
T_1	T_1
T_2	T_2
Tab	टॉब
tab	टॉब
Tab Order	टॉब क्रम
Tab stop	टॉब रुकावट
Tab stop position	टॉब रुकावट स्तान
Tab stops	टॉब रुकावट
Tab Stops	टॉब रुकावट
Table	सारणी
Table cell	सारणी कोष्ठ
Table changed	सारणी परिवर्तन हूआ
Table Changes	सारणी परिवर्तनें
Table Contents	सारणी विषय
Table Control	सारणी नियंत्रण
Table description	सारणी विवरण
Table Design	सारणी डिसैन
Table Format	सारणी रचना
Table formula	सारणी सूत्र
Table Heading	सारणी शीर्षक
Table heading	सारणी शीर्षक
Table index 1	सारणी अनुक्रमणी 1
Table index heading	सारणी अनुक्रमणी शीर्षक
Table indexes	सारणी अनुक्रमणी
Table Limits	सारणी सीमा
Table limits	सारणी सीमा
Table name	सारणी नाम
Table Name	सारणी नाम
Table Object Bar	सारणी वस्तु पट्टी
Table of Contents	विषयसूची सारणी
Table of contents	विषयसूची सारणी
Table of Objects	वस्तुओं का सारणी
Table of Values	मूल्यों का सारणी
Table properties	सारणी विशेषतायें
Table row	सारणी पंक्ति
Table View	सारणी दृश्य
Table view	सारणी दृश्य
Table: Fixed	सारणी: स्थिर
Table: Fixed, Proportional	सारणी: स्थिर, अनुरूप
Table: Variable	सारणी: परिवर्तनीय
Tables	सारणियाँ
Tables involved	सारणी सम्बद्ध
Tabloid	टॉब्लोइड्
Tabs	टॉब्स
Tabs and spaces	टॉब्स और अंतरें
Tabstop	टॉबरुकावट
Tabular	सारणीबद्ध्
tabulator	सारणीकार
Tabulator	सारणीकार
Taiwanese	तैवानिस
Tajikistan	तजिकिस्तान
Tamil	तमिल
Tangent	टॉन्जेन्ट्
TANH	TANH
Tape drive	टेप ड्रइव्
Target	लक्ष्य
Target Directory	लक्ष्य डैरक्टरी
Target Frame	लक्ष्य फ्रेम
Target in document	लेखपत्र में लक्ष्य
Target URL	लक्ष्य URL
Target value	लक्ष्य मूल्य
Target's Context	लक्ष्य का सन्धर्भ
Task Always Visible	काम सदा गोचर
Tasks Events	काम घटना
Tatar	टटर
TDIST	TDIST
Techn. documentation	पारिभाषिक लेखपत्र
Tel.	दूरभाष
Tel. (Home)	दूरभाष (घर)
Tel. (home)	दूरभाष (घर)
Tel. (Home/Work)	दूरभाष (घर/काम)
Tel. (mobile)	दूरभाष (मोबैल)
Tel. (office)	दूरभाष (दफ्तर)
Tel. (other)	दूरभाष (अन्य)
Tel. (Work)	दूरभाष (काम)
Tel. (work)	दूरभाष (काम)
Tel.:	दूरभाष:
Telefax	टेलिफॉक्स
Telephone	दूरभाष
Teletype	टेलिटइप
Telnet	टेलनेट्
Telugu	तेलुगु
Template	नमूना
Template directory	नमूना डैरक्टरी
Template file name	नमूना फाइल का नाम
Template Management	नमूना प्रबन्ध
Template path	नमूना मार्ग
Template	नमूना
Templates	नमूनें
Temporary	अस्थायी
Test	जाँच
Test text	जाँच टेक्स्ट्
Text	टेक्स्ट्
text	टेक्स्ट्
Text <-> Table	टेक्स्ट् <-> सारणी
Text -> Record	टेक्स्ट् -> अभिलेख
Text anchor	टेक्स्ट् जोड़
Text Animation	टेक्स्ट् हुलास
Text area	टेक्स्ट् विस्तीर्ण
Text attributes	टेक्स्ट् ऐट्रिब्यूट्स
Text Attributes	टेक्स्ट् ऐट्रिब्यूट्स
Text body	टेक्स्ट् का मुख्य भाग
Text body indent	टेक्स्ट् का मुख्य भाग इन्डेन्ट
Text body justfied	टेक्स्ट् का मुख्य भाग व्यवस्थित
Text Boundaries	टेक्स्ट् सीमा
Text Box	टेक्स्ट् बॉक्स
Text color	टेक्स्ट् रंग
Text contains headers	टेक्स्ट् में शीर्षक है
Text Contour	टेक्स्ट् परिवेश
Text delimiter	टेक्स्ट् परिसीमित करनेवाला
Text direction	टेक्स्ट् दिशा
Text display	टेक्स्ट् प्रदर्शन
Text document	टेक्स्ट् लेखपत्र
Text Document	टेक्स्ट् लेखपत्र
Text Document Options	टेक्स्ट् लेखपत्र विकल्प
Text editing	टेक्स्ट् संपादन
Text Effects	टेक्स्ट् प्रभाव
Text file	टेक्स्ट् फाइल
Text Filters	टेक्स्ट् फिल्टरें
Text flow	टेक्स्ट् धारा
Text Flow	टेक्स्ट् धारा
Text format	टेक्स्ट् रचना
Text Format	टेक्स्ट् रचना
Text formula	टेक्स्ट् सूत्र
Text frame	टेक्स्ट् फ्रेम
Text frames	टेक्स्ट् फ्रेम
Text Import	टेक्स्ट् आयात
Text Length	टेक्स्ट् लम्बाई
Text Limits	टेक्स्ट् सीमा
Text limits	टेक्स्ट् सीमा
Text Mode	टेक्स्ट् प्रकार
Text mode	टेक्स्ट् प्रकार
Text modified	टेक्स्ट् बदल हुआ
Text Object Bar	टेक्स्ट् वस्तु पट्टी
Text Object Bar/Web	टेक्स्ट् वस्तु पट्टी/वेब
Text objects	टेक्स्ट् वस्तु
Text only	केवल टेक्स्ट्
Text overflow	टेक्स्ट् अधिकता
Text Placeholders	टेक्स्ट् स्थानधारक
Text placeholders	टेक्स्ट् स्थानधारक
Text position	टेक्स्ट् स्थान
Text separator	टेक्स्ट् अलगानेवाला
Text Status	टेक्स्ट् वस्तुस्थिति
Text Styles	टेक्स्ट् शैलियाँ
Text template group	टेक्स्ट् नमूना समूह
Text Wrap	टेक्स्ट् लपेटना
Text/Web	टेक्स्ट्/वेब
Text	टेक्स्ट्
text_1	टेक्स्ट्_1
text_2	टेक्स्ट्_2
Texture	बनावट
Textures	बनावटियाँ
Th	टिएच
Thaana	थाना
Thai	ताई
Thailand	ताइलॉन्ड
The data array.	ड़ॉटा श्रेणी
The formula cell	सूत्र कोष्ठ
The population size	जन संख्या परिमाण
Theme ID	प्रकरण ID
Theme name invalid!	अमान्य प्रकरण नाम!
Theme Selection	प्रकरण चूनाव
Theme;Themes	प्रकरण;प्रकरण
Then by	फिर से
Then, Else	फिर, मगर
Then_value	फिर_मूल्य
There Exists	वहाँ रह था
Thesaurus	शब्दकोश
Thesis	लेख
thin	पतला
Third Outline Level	तीसरा बाहरी रूपरेखा सतह
Thousands separator	हजार अलगानेवाला
Thread	पिरोना
Threaded	पिरोना
Three Slides	तीन स्लइडस
Threshold value	थ्रेशोल्ड मूल्य
Through	में से
Tibetan	टिबेटियन
Tick marks	टिक मार्क
Ticker	घड़ी
Ticker direction	घड़ी दिशा
Ticker start inside	घड़ी प्रारंभ भीतर
Ticker step size	घड़ी स्टेप परिमाण
Ticker stop inside	घड़ी रुकावट अन्दर
Tilde	टिल्ड
Tile	टइल
Tile fill	टइल भरो
Tile pages	टइल पृष्ठ
Tile size	टइल परिमाण
Tile Windows	टइल विन्डो
Tile, direct	टइल, सीधा
Time	समय
TIME	TIME
Time (fixed)	समय (स्थिर)
Time (variable)	समय (परिवर्तनीय)
Time Field	समय क्षेत्र
Time Format	समय रचना
Time Frame	समय फ्रेम
Time max.	अधिकतम समय
Time min.	न्यूनतम समय
Time remaining (estimated)	बचा हुआ समय (आगणित)
Time unit	समय इकाई
Timeout	समय पूरा हुआ
TIMEVALUE	TIMEVALUE
TINV	TINV
Tip	सुझाव
Tips	सुझावें
Title	शीर्षक
Title (X Axis)	शीर्षक (X अक्षरेखा)
Title (Y Axis)	शीर्षक (Y अक्षरेखा)
Title (Z Axis)	शीर्षक (Z अक्षरेखा)
Title / Data	शीर्षक / ड़ॉटा
Title Background	शीर्षक पृष्ठभाग
Title Font	शीर्षक अक्षर
Title On/Off	शीर्षक शुरु/बंद
Title Only	केवल शीर्षक
Title row	शीर्षक पंक्ति
Title Slide	शीर्षक स्लइड
Title text	शीर्षक टेक्स्ट्
Title texts	शीर्षक टेक्स्ट्स
Title, Chart	शीर्षक, चार्ट
Title, Chart, Text	शीर्षक, चार्ट, टेक्स्ट्
Title, Clipart, Text	शीर्षक, क्लिपआर्ट, टेक्स्ट्
Title, Object	शीर्षक, वस्तु
Title, Object, Text	शीर्षक, वस्तु, टेक्स्ट्
Title, Organization chart	शीर्षक, निर्माण, चार्ट
Title, Spreadsheet	शीर्षक, स्प्रेडशीट्
Title, Text	शीर्षक, टेक्स्ट्
Title, Text, Chart	शीर्षक, टेक्स्ट्, चार्ट
Title, Text, Object	शीर्षक, टेक्स्ट्, वस्तु
Title/Position	शीर्षक/स्थान
Title/Profession	शीर्षक/पदवी
Title1	शीर्षक1
Title2	शीर्षक2
To	को
to	को
To 3D	3D में
To Background	पृष्ठभाग में
To Bitmap	बिट्मॉप में
To Cell	कोष्ठ में
to character	अक्षर में
To Character	अक्षर में
To Character Left	अक्षर की बायाँ ओर
To Column Begin	स्तंभ की प्रारंभ में
To Column End	स्तंभ की अंत में
To Contour	परिवेश में
To Current Cell	वर्तमान कोष्ठ में
To Curve	वक्र में
To Do	करने केलिए
To do by	से करने केलिए
To document	लेखपत्र में
To Document Begin	लेखपत्र का प्रारंभ में
To Document End	लेखपत्र का अंत में
To File Begin	फाइल का प्रारंभ में
To File End	फाइल का अंत में
To Footer	पृष्ठ के अधोभाग की टीका में
To Footnote Anchor	पृष्ठ के नीचे की टिप्पणी जोड़ में
To Foreground	सामने की ओर
To Frame	फ्रेम में
To front	आगे की ओर
To given page	दिया हुआ पुष्ठ में
To Header	शीर्षक में
To Line	रेखा में
To Line Begin	रेखा आरंभ में
To Line Below	नीचे की रेखा में
To Metafile	मेटाफाइल में
To Next Bookmark	अगला पृष्ठसंकेत में
To Next Footnote	अगला पृष्ठ के नीचे की टिप्पणी में
To Next Frame	अगला फ्रेम में
To Next Object	अगला वस्तु में
To Next Paragraph	अगला परिच्छेद में
To Next Placeholder	अगला स्थानधारक में
To Next Section	अगला विभाग में
To Next Sentence	अगला वाक्य में
To Next Sheet	अगला शीट् में
To Next Table	अगला सारणी में
To Page	पृष्ठ में
To page	पृष्ठ में
To Page Begin	पृष्ठ के प्रारंभ में
To Page End	पृष्ठ के अंत में
to paragraph	परिच्छेद में
To Paragraph	परिच्छेद में
To Paragraph Begin	परिच्छेद आरंभ में
To Paragraph End	परिच्छेद अंत में
To Polygon	बहुभुज में
To Previous Bookmark	पिछला स्तंभ में
To Previous Footnote	पिछला पृष्ठ के नीचे की टीका में
To Previous Object	पिछला वस्तु में
To Previous Paragraph	पिछला परिच्छेद में
To Previous Placeholder	पिछला स्थानधारक में
To Previous Section	पिछला विभाग में
To Previous Sentence	पिछला वाक्य में
To Previous Sheet	पिछला शीट् में
To Previous Table	पिछला सारणी में
To Reference	रेफरेन्स में
To right margin	दाहिना किनारा में
To Table Begin	सारणी का प्रारंभ में
To Table End	सारणी का अंत में
To the left	बायाँ ओर
To the right	दाहिनी ओर
To Top Line	ऊपर का रेखा में
To Word Left	शब्द का बायाँ ओर
To Word Right	शब्द का दाहिनी ओर
TODAY	TODAY
Today	आज
Toggle	टॉगल
Tolerance	सहनशीलता
Toner low	कम टोनर
Too many conditions	बहूत सारे शर्तें
Too many files	बहूत सारे फाइलें
Toolbar Configuration	औज़ार पट्टी का रूपरेखा
Toolbars	औज़ार पट्टी
Tools	औज़ार
Top	ऊपर
top	ऊपर
Top Left	ऊपर बायाँ
Top margin	ऊपर किनारा
Top of baseline	आधाररेखा का ऊपर
Top of character	अक्षरों का ऊपर
Top of line	रेखा का ऊपर
Top Right	ऊपर दाहिना
Top to bottom	ऊपर से नीचे
Torus	टोरस्
Total	कुलजोड़
Total columns	कुल स्तम्भें
Total Contents	कुल विषय
Total groups	कुल समूह
Total page count	कुल पूष्ठ गिनती
Total rows	कुल पंक्तियाँ
Total Width	कुल चौड़ाई
Toward	समीप
Trace Dependent	अवलम्बी जाचँ
Trace Dependents	अवलम्बियों का जाँच
Trace Error	जाचँ गलती
Trace Precedent	पूर्व अवलम्बी को जाचँ करो
Trace Precedents	पूर्व अवलम्बी को जाचँ करो
Transaction file (MB)	ट्रान्साक्शन फाइल (MB)
TRANSACTIONLOG	TRANSACTIONLOG
Transactions	ट्रान्साक्शन
Transfer failed	स्थानान्तर असफल हुआ
Transfer to TestTool	जाँच औज़ार में स्थानान्तर करो
Transferring message	संदेशों को स्थानान्तर किया जा रहा है
Transition	परिवर्तन
Transition Speed	परिवर्तन गति
Transition type selection	परिवर्तन वर्ग चूनाव
Translation	अनुवाद
Transparency	पारदर्शकता
Transparency color	पारदर्शकता रंग
Transparency gradient	पारदर्शकता ग्रेडियण्ट
Transparency mode	पारदर्शकता प्रकार
Transparent	पारदर्शक
Transparent color	पारदर्शक रंग
Transparent gradient	पारदर्शक ग्रेडिऐन्ट
TRANSPOSE	TRANSPOSE
Transpose	ट्रान्स्पोस
Travel	यात्रा
TREND	TREND
Trigger hyperlink	ट्रिग्गर हैपरलिंक
TRIM	TRIM
Trim	सुगठित
TRIMMEAN	TRIMMEAN
Trinidad and Tobago	ट्रिनाडाड और टोबागो
Triple	तिगुना
Triple Curve Integral	तिगुना वक्र सम्पूर्ण
Triple Dot	तिगुना बिंदू
Triple Integral	तिगुना सम्पूर्ण
Tristate	तिगुना
True Colors	सच्चा रंग
TRUNC	TRUNC
TTEST	TTEST
Tu	टियु
Tubes	नलों
Tubes, deep	नलों,गहरा
Tubes, percent	नलों,प्रतिशत
Tubes, stacked	नलों,टाल लगो
Tunisia	टूनिसिया
Turkey	टर्कि
Turkish	टर्किश
Turkmenistan	टर्किमेनिसतान
Turquoise	टर्कोइस
Two Slides	दो स्लइडस
Type	वर्ग
Type and title	वर्ग ओर शीर्षक
Type formatting	वर्ग रचना
Type of circle	वृत्त वर्ग
Type of connector	कनेक्टर वर्ग
Type of dimensioning	वर्ग परिमाण
Type of legend	कहावत वर्ग
Type of literature	साहित्य वर्ग
Type of submission	उपस्थापन वर्ग
Ukraine	यूक्रेइन
Ukrainian	युक्रेनियन
ultra bold	अत्यन्त मोटा
ultra thin	अत्यन्त पतला
Ultrafine dashed	अत्यन्त हॉश
Ultrafine dotted (variable)	अत्यन्त उत्तम बिंदी (परिवर्तनीय)
Unary operator expected	यूनारि प्रवर्तक की प्रतीक्षा
Unary/Binary Operators	यूनारि/बैनारि प्रवर्तक
Unchanged	परिवर्तन न किया
Uncover	खोलो
Uncover from Bottom	नीचे से खोलो
Uncover from Left	बायाँ ओर से खोलो
Uncover from Right	बायाँ ओर से खोलो
Uncover from Top	ऊपर से खोलो
Underline	रेखांकित
Underline (Dash bold)	रेखांकित  (डॉश मोटा)
Underline (dashes)	रेखांकित  (डॉश)
Underline (dot dash)	रेखांकित  (बिन्दु डॉश)
Underline (Double wave)	रेखांकित  (द्विगुणित लहर)
Underline (long dashes)	रेखांकित  (लम्बा डॉश)
Underline (small wave)	रेखांकित  (छोटा लहर)
Underline (Wave)	रेखांकित  (लहर)
Underline (wave, bold)	रेखांकित  (लहर, मोटा)
Underline: Dotted	रेखांकित: बिन्दी
Underline: Double	रेखांकित: द्विगुणित
Underline: double	रेखांकित: द्विगुणित
Underline: Off	रेखांकित: बंद
Underline: Single	रेखांकित: अकेला
Underlined (Bold)	रेखांकित (मोटा)
Underlining	रेखांकित करना
underscore off	अन्डरस्कोर बंद
underscore on	अन्डरस्कोर शुरु
Undo	अनावृत्ति
undo	अनावृत्ति
Undo Print Range	छपाई फैलाव को अनावृत्ति करो
Undo Selection	चूनाव अनावृत्ति करो
Undo: Data entry	अनावृत्ति: ड़ॉटा प्रविष्टि
Undo: Data input	अनावृत्ति: ड़ॉटा इनपुट
Undo: Entry	अनावृत्ति: प्रविष्टि
Unexpected character	आकस्मिक अक्षर
Unformatted text	रचना न की हुयी टेक्स्ट्
Ungroup	वर्ग न किया
Ungroup drawing objects	चित्र वस्तु को वर्ग न करो
Ungroup Metafile(s)	मेटाफाइलों को वर्ग न करो
Ungrouping not possible	वर्ग न करना संभव नहीं
Union	यूनियन
Unique	अपूर्व
United Arab Emirates	युनइटेड अरब एमिरेट्स
United Kingdom	युनइटेड किन्गडम्
University	विश्वविद्यालय
Unix	Unix
UNIX Text	UNIX टेक्स्ट्
Unknown	अज्ञात
unknown	अज्ञात
Unknown attribute	अज्ञात ऐट्रिब्यूट्
Unknown error occurred	अज्ञात गलती घटित हुआ
Unknown file format!	अज्ञात फाइल रचना!
Unknown filter	अज्ञात फिल्टर
Unknown graphic format	अज्ञात सुचित्र रचना
Unknown graphics format	अज्ञात सुचित्र रचना
Unknown Server	अज्ञात सर्वर
Unknown source	अज्ञात मूल
Unknown word	अज्ञात शब्द
Unlink	कड़ी हटाओ
Unlink Frames	फ्रेमों का कड़ी हटाओ
Unlink text frames	टेक्स्ट् फ्रेमों का कड़ी हटाओ
Unlinked graphic	कड़ी हटाया हुआ सुचित्र
Unmark	चिह्नित न किया
Unmarked	चिह्नित न किया
unnamed	नाम रहित
Unnamed	नाम रहित
Unnamed action	नाम रहित कार्य
Unprotect	अरक्षित
Unprotect cells	अरक्षित कोष्ठ
Unprotect document	अरक्षित लेखपत्र
Unprotect sheet	अरक्षित शीट्
Unpublished	अप्रकाशित
Unread	न पढा हुआ
Unread Documents	न पढा हुआ लेखपत्र
Unread Messages	न पढा हुआ संदेश
unread only	केवल न पढा हुआ
Unrestricted	अप्रतिबन्ध
Unsent	न भेजा हुआ
Unsent Messages	न भेजा हुआ संदेश
Unspecific Name	निर्दिष्ट न की हुयी नाम
Untitled	शीर्षक-रहित
Untitled 1	शीर्षक-रहित 1
Untitled 2	शीर्षक-रहित 2
Untitled 3	शीर्षक-रहित 3
Untitled 4	शीर्षक-रहित 4
Untitled 5	शीर्षक-रहित 5
Untitled 6	शीर्षक-रहित 6
Untitled 7	शीर्षक-रहित 7
Untitled 8	शीर्षक-रहित 8
Untitled 9	शीर्षक-रहित 9
Unvisited links	भेंट न की हुयी लिंक्स
Unzip	अनज़िप करो
up	ऊपर
Up	ऊपर
Up Arrow	ऊपर का तीर
Up One Level	ऊपर एक सतह
Update	अपडेट् करो
Update All	सब अपडेट् करो
Update All Links	सब लिंक्स को अपडेट् करो
Update canceled	अपडेट् को रद्द किया
Update cascade	संयुक्त अपडेट्
Update Chart	चार्ट को अपडेट् करो
Update charts automatically	चार्ट को स्वाचालित प्रकार से अपडेट् करो
Update completed	अपडेट् पूरा हुआ
Update data	ड़ॉटा को अपडेट् करो
Update Fields	क्षेत्र को अपडेट् करो
Update fields automatically	क्षेत्र को स्वाचालित प्रकार से अपडेट् करो
Update Help	सहायता को अपडेट् करो
Update Index	अनुक्रमणी अपडेट् करो
Update Indexes	अनुक्रमणी अपडेट् करो
Update Input Fields	इनपुट क्षेत्र को अपडेट् करो
Update Installation	प्रतिष्ठापन को अपडेट् करो
Update Link	कड़ी को अपडेट् करो
Update links	लिंक्स को अपडेट् करो
Update options	विकल्पों को अपडेट् करो
Update Style	शैली अपडेट् करो
Update Template (apply)	नमूना अपडेट् करो (लागू करो)
Update via Internet	इन्टरनेट द्वारा अपडेट् करो
Update When Opened	खोलने के समय अपडेट् करो
Update when opened	खोलने के समय अपडेट् करो
Updating	अपडेट् करना
Updating folder	कोष्ठ को अपडेट् करना
Updating immediately	तुरन्त अपडेट् करना
Updating in progress	अपडेट् करना जारी है
Updating Index	अनुक्रमणी अपडेट् करना
Updating subfolders	अधीनकोष्ठों को अपडेट् करना
Upgrade Installation	प्रतिष्ठापन को अपग्रेड करों
UPPER	UPPER
Upper	ऊपरी
Upper Arc	ऊपरी चाप
Upper border spacing	ऊपरी किनारे को अंतर देना
Upper case only	केवल ऊपरी केस
Upper Indicator	ऊपरी निदर्शक
Upper limit	ऊपरी सीमा
Upper Limit	ऊपरी सीमा
Upper Margin	ऊपरी किनारा
Upper Semicircle	ऊपर अर्धवृत्त
Upright	अपरइट्
Upwards	ऊपर की ओर
Urdu	उर्दु
Urdu (India)	उर्दु (भारत)
Urdu (Pakistan)	उर्दु (पाकिस्तान)
Urgent	अत्यावश्यक
URL	URL
URL Button	URL बटन
URL for listeners	सुननेवालों का URL
URL for presentation	प्रस्तुति केलिए URL
URL Recognition	URL पहचान
URL recognition	URL पहचान
URL Text	URL टेक्स्ट्
URL_Reg	URL_Reg
Uruguay	उरूगूवे
USA	USA
Use	उपयोग
Use as Template	नमूना जैसे उपयोग करो
Use background cache	पृष्टभूमि कॉश का उपयोग करो
Use browser colors	ब्रउज़र रंग का उपयोग करो
Use default hyphenation	अनुपस्थिति हाइफनेशन का उपयोग करो
Use default thesaurus	अनुपस्थिति शब्दकोश का उपयोग करो
Use Dithering	डैथरिंन्ग का उपयोग करो
use document immediately	लेखपत्र को तुरन्त उपयोग करो
Use entire height	सम्पूर्ण ऊँचाई का उपयोग करो
Use entire width	सम्पूर्ण चौड़ाई का उपयोग करो
Use external browser	बाहरी ब्रउज़र का उपयोग करो
Use function	फंक्शन् का उपयोग
Use hard attributes	हार्ड ऐट्रिब्यूट्स का उपयोग करो
Use Internet Explorer	इन्टरनेट एक्सप्लोरर का उपयोग करो
Use OpenGL	OpenGL का उपयोग करो
Use replacement table	प्रतिस्थापना सारणी का उपयोग करो
Use scenario	विवरण का उपयोग करो
Use selection	चूनाव का उपयोग करो
Use standard hyphenation	स्टान्डर्ड हाइफनेशन का उपयोग करो
Use standard thesaurus	स्टान्डर्ड शब्दकोश का उपयोग करो
Use system settings	सिस्टम निर्धारण का उपयोग करो
User	उपभोक्ता
User Configuration	उपभोक्ता रूपरेखा
User Data	उपभोक्ता ड़ॉटा
User Defined	उपभोक्ता से परिभाषित
User Dictionaries	उपभोक्ता शब्दकोश
User Directory	उपभोक्ता डैरक्टरी
User Entry	उपभोक्ता प्रविष्टि
User Field	उपभोक्ता क्षेत्र
User ID	उपभोक्ता ID
User Index 1	उपभोक्ता अनुक्रमणी 1
User Index 10	उपभोक्ता अनुक्रमणी 10
User Index 2	उपभोक्ता अनुक्रमणी 2
User Index 3	उपभोक्ता अनुक्रमणी 3
User Index 4	उपभोक्ता अनुक्रमणी 4
User Index 5	उपभोक्ता अनुक्रमणी 5
User Index 6	उपभोक्ता अनुक्रमणी 6
User Index 7	उपभोक्ता अनुक्रमणी 7
User Index 8	उपभोक्ता अनुक्रमणी 8
User Index 9	उपभोक्ता अनुक्रमणी 9
User Index Heading	उपभोक्ता अनुक्रमणी शीर्षक
User intervention necessary	उपभोक्ता हस्तक्षेप आवश्यक है
User name	उपभोक्ता नाम
User selection	उपभोक्ता चुनाव
User settings	उपभोक्ता निर्धारण
User Settings	उपभोक्ता निर्धारण
User-defined	उपभोक्ता से परिभाषित
User-Defined	उपभोक्ता से परिभाषित
User-defined 1	उपभोक्ता से परिभाषित 1
User-defined 2	उपभोक्ता से परिभाषित 2
User-defined 3	उपभोक्ता से परिभाषित 3
User-defined 4	उपभोक्ता से परिभाषित 4
User-defined 5	उपभोक्ता से परिभाषित 5
User-defined field 1	उपभोक्ता से परिभाषित क्षेत्र 1
User-defined file sizes	उपभोक्ता से परिभाषित फाइल परिमाण
User-Defined Index	उपभोक्ता से परिभाषित अनुक्रमणी
User-defined no.	उपभोक्ता से परिभाषित संख्या
User-defined settings	उपभोक्ता से परिभाषित निर्धारण
User-defined1	उपभोक्ता से परिभाषित1
User's Guide	उपभोक्ता का पथप्रदर्शक
Using Help	सहायता उपयोग करने पर
Uzbek	उस्बेक
Uzbek (Cyrillic)	उस्बेक (सिरिलिक)
Uzbek (Latin)	उस्बेक (लेटिन)
Uzbekistan	उस्बेकिस्तान
V. Pitch	V. धूना
Validity	वैधता
Validity criteria	वैधता सिद्धान्त
Value	मूल्य
value	मूल्य
Value highlighting	मूल्य को विशेष प्रकार से दिखाना
Value Highlighting	मूल्य को विशेष प्रकार से दिखाना
Value Highlighting On/Off	मूल्य को विशेष प्रकार से दिखाना शुरु/बंद
Value max.	अधिकतम मूल्य
Value min.	न्यूनतम मूल्य
Values	मूल्य
VAR	VAR
Var (Sample)	वेरिऐबल (नमूना)
VARA	VARA
Variable	परिवर्ती
Variable cell	परिवर्तनीय कोष्ठ
Variable expected	परिवर्ती की प्रतीक्षा
Variable not defined	परिवर्ती परिभाषित नहीं
Variables	परिवर्ती
Variance	वेरिऐन्स
Variants	वेरिऐन्ट्स
Variations	परिवर्तनें
Various attributes	विविध ऐट्रिब्यूट्स
VARP	VARP
VarP (Population)	VarP (जनसंख्या)
VARPA	VARPA
vCalendar-file	vCalendar-फाइल
vCard file	vCard फाइल
VDB	VDB
Vector Arrow	वेक्टर तीर रेखा
Vector element	वेक्टर वस्तु
Vectorized image	वेक्टरइस्ड चित्र
Venezuela	वेनेझुवेला
verified	प्रामाणित
Verifying help files	सहायता फाइलों को प्रामाणित कर रहा हैं
Verifying local settings	स्थानिक निर्धारणों प्रामाणित कर रहा हैं
Version	आवर्तन
Version comment	आवर्तन अपवाद
Version field	आवर्तन क्षेत्र
Version Incompatibility	आवर्तन अनुकूल नहीं है
Version Visible	आवर्तन प्रकट हैं
Versions	आवर्तन
Versions of	का आवर्तन
Vert. Scrollbar	लंबरूप स्क्रॉल पट्टी
Vertical	लंबरूप
Vertical alignment	लंबरूप पंक्तिकरण
Vertical alignment default	अनुपस्थिति में लंबरूप पंक्तिकरण
Vertical grid on/off	लंबरूप जाल शुरु/बंद
Vertical line	लंबरूप रेखा
Vertical Lines	लंबरूप रेखाएँ
Vertical Pen	लंबरूप कलम
Vertical pitch	लंबरूप पिच
Vertical Ruler	लंबरूप रूलर
Vertical ruler	लंबरूप रूलर
Vertical scroll	लंबरूप स्क्रॉल
Vertical scroll bar	लंबरूप स्क्रॉल पट्टी
Vertical Scroll bar	लंबरूप स्क्रॉल पट्टी
Vertical shadow outline	लंबरूप छाया बाहरी रूपरेखा
Vertical Stack	लंबरूप स्टॉक
Vertical text anchor	लंबरूप टेक्स्ट् जोड़
Vertically	लंबरूप से
vertically	लंबरूप से
via	द्वारा
Video	वीडियो
Video file	वीडियो फाइल
Viet Nam	वियटनाम
View	दृश्य
View 100%	दृश्य 100%
View 200%	दृश्य 200%
View 50%	दृश्य 50%
View Details	दृश्य विवरण
View Options	दृश्य विकल्प
Viewed Contents	दृश्य सन्तोष
VIM Account	VIM हिसाब
VIM To	VIM पर
Violet	बैंगनी
Visibility	प्रत्यक्षता
Visible	प्रकट
Visible Buttons	प्रकट बटनों
Visible Grid	प्रकट जाल
Visible grid	प्रकट जाल
Visited Internet Link	देखा इन्टरनेट लडि
Visited Link	देखा लडि
Visited link	देखा लडि
Visited links	देखा लडि
VLOOKUP	VLOOKUP
Volume	घुमाव
Volume number	घुमाव का गिनती
VRML file	VRML फाइल
Waiting	ठहरा हुआ है
Wall	वॉल
Warming up	उसकाना
Warning Print Options	चेतावनी छापना विकल्प
Warnings	चेतावनी
Watch	निरीक्षण
Water	जल
Watermark	जलचिह्न
Wave	लहर
Wave (Bold)	लहर (मोटा)
Wavyline	लहररेखा
We	हम
Web view	वेब दृश्य
Week	सप्ताह
WEEKDAY	WEEKDAY
Weekday	सप्ताह का दिन
Weekend	सप्ताह का अंत
Weekly Project Meeting	सप्ताहिक प्रोजेक्ट् सभा
WEEKNUM	WEEKNUM
Weeks	सप्ताह
WeeksInYear	WeeksInYear
WEIBULL	WEIBULL
Weierstrass p	वैयर्स्ट्रस् पि
Weight	भार
When initiating	जब आरंभ करने के समय
When loading	लोड करने के समय
When reloading	पुनः लोड करने के समय
When rotating	घुमाने के समय
When unloading	अन लोड करने के समय
Where to search	कहाँ खोजना
While Typing	जब छापने के समय
White	सफेद
Whole Numbers	पूर्ण संख्या
Whole word	पूर्ण शब्द
Whole words only	केवल पूर्ण शब्द
Window control	विन्डो नियंत्रण
Windows	विन्डोस
width	चौड़ाई
Width	चौड़ाई
With	सहित
With condition	शर्त सहित
With contents	विषय सहित
with copy	प्रतिलिपि सहित
With Page Style	पूष्ठ शैली सहित
With window contents	विन्डो विषय सहित
With X	X सहित
Without contents	विषय रहित
Word Completion	शब्द पूर्ण हूआ
word is	शब्द
Word only	केवल शब्द
Word processing	शब्द कार्यवाही हो रहा है
Words	शब्द
Words with numbers	संख्या सहित शब्द
Workspace	कार्यस्थान
Workstation Installation	कार्यस्थान प्रतिष्ठापन
Workweek	कामसप्ताह
Wrap	लपेटना
Wrap Contour On	परिवेश लपेटना शुरु
Wrap First Paragraph	पहिला परिच्छेद को लपेटो
Wrap Left	बायाँ ओर से लपेटो
Wrap Off	लपेटना बंद
Wrap On	लपेटना शुरु
Wrap Optimal	योग्य लपेटना
Wrap Right	दाहिनी ओर से लपेटो
Wrap Through	से लपेटो
Wrap Transparent	पारदर्शक लपेटो
Write Error	गलती लिखो
Write Notes	टिप्पणी लिखो
Writing configuration files	रूपरेखा फाइलों को लिखना
Wrong check amount	गलत जाँच जोड़
Wrong parameter	गलत पैरामीटर
Wrong password	गलत कूटशब्द
Wrong Password!	गलत कूटशब्द!
Wrong table formula	गलत सारणी सूत्र
WWW document	WWW लेखपत्र
X Axis	X अक्षरेखा
X axis	X अक्षरेखा
X Axis Title	X अक्षरेखा का शीर्षक
X axis title	X अक्षरेखा का शीर्षक
X Coordinate	X समकक्ष
X Offset	X ऑफसेट्ट
X Position	X स्थान
X Tile	X टइल
XMailer	XMailer
XML-iCalendar-File	XML-iCalendar-फाइल
XNews Reader	XNews Reader
XPriority	XPriority
Xref	Xref
XWindows	XWindows
XY Chart	XY चार्ट
XYZ Chart	XYZ चार्ट
Y axis	Y अक्षरेखा
Y Axis	Y अक्षरेखा
Y Axis Title	Y अक्षरेखा का शीर्षक
Y axis title	Y अक्षरेखा का शीर्षक
Y Coordinate	Y समकक्ष
Y main grid	Y मुख्य जाल
Y minor grid	Y अमुख्य जाल
Y Offset	Y ऑफसेट्ट
Y Position	Y स्थान
Y Tile	Y टइल
Year	वर्ष
YEAR	YEAR
Year (two digits)	वर्ष (दो अंक में )
Year of publication	प्रकाशन वर्ष
Year Overview	वर्ष अवलोकन
Years	वर्ष
Yellow	पीला
Yes	हाँ
Yugoslavia	युगोस्लोविया
Z Axis	Z अक्षरेखा
Z axis	Z अक्षरेखा
Z Axis Title	Z अक्षरेखा शीर्षक
Z axis title	Z अक्षरेखा शीर्षक
Z main grid	Z मुख्य जाल
Z minor grid	Z अमुख्य जाल
Zero Values	शून्य मूल्य
Zero values	शून्य मूल्य
Zip (Postal) code/City	Zip (पोस्टल) कोड/नगर
Zip code	Zip कोड
ZIP file	ZIP फाइल
Zip/City	Zip/नगर
Zoom	झूम
Zoom 100%	झूम 100%
Zoom in	झूम अन्दर
Zoom In	झूम अन्दर
Zoom Next	झूम आगे
Zoom out	झूम बाहर
Zoom Out	झूम बाहर
Zoom Page	झूम पृष्ठ
Zoom Page Width	झूम पृष्ठ चौड़ाई
Zoom Previous	झूम पीछे
Zoom to	में झूम
ZTEST	ZTEST

----------------------------------------------------This document is a copyright of Centre for Development of Advanced Computing(Formerly NCST) 2003
----------------------------------------------------
